"BA Code","Timestamp (Hour Ending)","Demand (MWh)","Demand Forecast (MWh)","Net Generation (MWh)","Total Interchange (MWh)"
ISNE,"4/1/2022 12 a.m. EDT",11016,10550,9413,-1603
ISNE,"4/1/2022 1 a.m. EDT",10744,10110,9106,-1638
ISNE,"4/1/2022 2 a.m. EDT",10568,9710,8715,-1853
ISNE,"4/1/2022 3 a.m. EDT",10355,9500,8522,-1833
ISNE,"4/1/2022 4 a.m. EDT",10300,9450,8415,-1885
ISNE,"4/1/2022 5 a.m. EDT",10533,9700,8512,-2021
ISNE,"4/1/2022 6 a.m. EDT",11062,10490,9089,-1973
ISNE,"4/1/2022 7 a.m. EDT",12022,11850,10305,-1717
ISNE,"4/1/2022 8 a.m. EDT",12766,12760,11243,-1523
ISNE,"4/1/2022 9 a.m. EDT",12956,12930,11387,-1569
ISNE,"4/1/2022 10 a.m. EDT",12422,12390,10808,-1614
ISNE,"4/1/2022 11 a.m. EDT",11945,11940,10740,-1205
ISNE,"4/1/2022 12 p.m. EDT",12097,12090,10921,-1176
ISNE,"4/1/2022 1 p.m. EDT",12150,12130,10822,-1328
ISNE,"4/1/2022 2 p.m. EDT",11873,11700,10537,-1336
ISNE,"4/1/2022 3 p.m. EDT",11804,11590,10444,-1360
ISNE,"4/1/2022 4 p.m. EDT",11765,11650,10372,-1393
ISNE,"4/1/2022 5 p.m. EDT",12092,12020,10523,-1569
ISNE,"4/1/2022 6 p.m. EDT",12649,12640,11376,-1273
ISNE,"4/1/2022 7 p.m. EDT",13002,13070,11633,-1369
ISNE,"4/1/2022 8 p.m. EDT",13477,13390,12230,-1247
ISNE,"4/1/2022 9 p.m. EDT",13308,13230,12037,-1271
ISNE,"4/1/2022 10 p.m. EDT",12727,12640,11347,-1380
ISNE,"4/1/2022 11 p.m. EDT",12246,11850,10789,-1457
ISNE,"4/2/2022 12 a.m. EDT",11480,11070,10009,-1471
ISNE,"4/2/2022 1 a.m. EDT",10938,10620,9513,-1425
ISNE,"4/2/2022 2 a.m. EDT",10910,10290,9442,-1468
ISNE,"4/2/2022 3 a.m. EDT",10972,10130,9367,-1605
ISNE,"4/2/2022 4 a.m. EDT",10949,10090,9382,-1567
ISNE,"4/2/2022 5 a.m. EDT",10834,10230,9416,-1418
ISNE,"4/2/2022 6 a.m. EDT",11032,10630,9642,-1390
ISNE,"4/2/2022 7 a.m. EDT",11301,11300,9904,-1397
ISNE,"4/2/2022 8 a.m. EDT",11687,11670,10375,-1312
ISNE,"4/2/2022 9 a.m. EDT",11279,11220,9829,-1450
ISNE,"4/2/2022 10 a.m. EDT",10790,10320,9427,-1363
ISNE,"4/2/2022 11 a.m. EDT",10149,9500,9124,-1025
ISNE,"4/2/2022 12 p.m. EDT",9939,9120,9097,-842
ISNE,"4/2/2022 1 p.m. EDT",9653,8880,8928,-725
ISNE,"4/2/2022 2 p.m. EDT",9507,8620,8614,-893
ISNE,"4/2/2022 3 p.m. EDT",9425,8510,8668,-757
ISNE,"4/2/2022 4 p.m. EDT",9517,8750,8805,-712
ISNE,"4/2/2022 5 p.m. EDT",9616,9700,8458,-1158
ISNE,"4/2/2022 6 p.m. EDT",10935,11040,9702,-1233
ISNE,"4/2/2022 7 p.m. EDT",12115,12060,10732,-1383
ISNE,"4/2/2022 8 p.m. EDT",12816,12610,11354,-1462
ISNE,"4/2/2022 9 p.m. EDT",12772,12540,11098,-1674
ISNE,"4/2/2022 10 p.m. EDT",12291,12170,10759,-1532
ISNE,"4/2/2022 11 p.m. EDT",11625,11510,10071,-1554
ISNE,"4/3/2022 12 a.m. EDT",10957,10840,9328,-1629
ISNE,"4/3/2022 1 a.m. EDT",11009,10420,9161,-1848
ISNE,"4/3/2022 2 a.m. EDT",10722,10090,8847,-1875
ISNE,"4/3/2022 3 a.m. EDT",10794,9930,8808,-1986
ISNE,"4/3/2022 4 a.m. EDT",10517,9920,8660,-1857
ISNE,"4/3/2022 5 a.m. EDT",10723,10050,8622,-2101
ISNE,"4/3/2022 6 a.m. EDT",10615,10340,8339,-2276
ISNE,"4/3/2022 7 a.m. EDT",10838,10780,8581,-2257
ISNE,"4/3/2022 8 a.m. EDT",11112,11100,8745,-2367
ISNE,"4/3/2022 9 a.m. EDT",11211,11200,9134,-2077
ISNE,"4/3/2022 10 a.m. EDT",10893,10770,9304,-1589
ISNE,"4/3/2022 11 a.m. EDT",10613,10500,9213,-1400
ISNE,"4/3/2022 12 p.m. EDT",10332,10430,9015,-1317
ISNE,"4/3/2022 1 p.m. EDT",10160,10560,8876,-1284
ISNE,"4/3/2022 2 p.m. EDT",10538,10690,9391,-1147
ISNE,"4/3/2022 3 p.m. EDT",11192,11000,10016,-1176
ISNE,"4/3/2022 4 p.m. EDT",11792,11330,10409,-1383
ISNE,"4/3/2022 5 p.m. EDT",12442,11970,10670,-1772
ISNE,"4/3/2022 6 p.m. EDT",13086,12760,11081,-2005
ISNE,"4/3/2022 7 p.m. EDT",13462,13210,11495,-1967
ISNE,"4/3/2022 8 p.m. EDT",13698,13450,11601,-2097
ISNE,"4/3/2022 9 p.m. EDT",13346,13160,11505,-1841
ISNE,"4/3/2022 10 p.m. EDT",12593,12440,10772,-1821
ISNE,"4/3/2022 11 p.m. EDT",11652,11570,9684,-1968
ISNE,"4/4/2022 12 a.m. EDT",10814,10790,8782,-2032
ISNE,"4/4/2022 1 a.m. EDT",10591,10240,8678,-1913
ISNE,"4/4/2022 2 a.m. EDT",10571,9910,8611,-1960
ISNE,"4/4/2022 3 a.m. EDT",10454,9780,8547,-1907
ISNE,"4/4/2022 4 a.m. EDT",10701,9860,8688,-2013
ISNE,"4/4/2022 5 a.m. EDT",10769,10230,8881,-1888
ISNE,"4/4/2022 6 a.m. EDT",11388,11250,9533,-1855
ISNE,"4/4/2022 7 a.m. EDT",12771,12840,10883,-1888
ISNE,"4/4/2022 8 a.m. EDT",13444,13580,11460,-1984
ISNE,"4/4/2022 9 a.m. EDT",12782,12890,11165,-1617
ISNE,"4/4/2022 10 a.m. EDT",11783,11900,10236,-1547
ISNE,"4/4/2022 11 a.m. EDT",10991,11130,9845,-1146
ISNE,"4/4/2022 12 p.m. EDT",10899,10730,9744,-1155
ISNE,"4/4/2022 1 p.m. EDT",10715,10660,9473,-1242
ISNE,"4/4/2022 2 p.m. EDT",10606,10640,9176,-1430
ISNE,"4/4/2022 3 p.m. EDT",10375,9550,9114,-1261
ISNE,"4/4/2022 4 p.m. EDT",10315,10060,9032,-1283
ISNE,"4/4/2022 5 p.m. EDT",11566,11140,10070,-1496
ISNE,"4/4/2022 6 p.m. EDT",12529,12670,10858,-1671
ISNE,"4/4/2022 7 p.m. EDT",13209,13450,11609,-1600
ISNE,"4/4/2022 8 p.m. EDT",13773,13890,11979,-1794
ISNE,"4/4/2022 9 p.m. EDT",13579,13610,11853,-1726
ISNE,"4/4/2022 10 p.m. EDT",12789,12800,11036,-1753
ISNE,"4/4/2022 11 p.m. EDT",11742,11770,9958,-1784
ISNE,"4/5/2022 12 a.m. EDT",10845,10880,9156,-1689
ISNE,"4/5/2022 1 a.m. EDT",10555,10360,8649,-1906
ISNE,"4/5/2022 2 a.m. EDT",10294,10090,8422,-1872
ISNE,"4/5/2022 3 a.m. EDT",10206,9910,8296,-1910
ISNE,"4/5/2022 4 a.m. EDT",10271,9940,8472,-1799
ISNE,"4/5/2022 5 a.m. EDT",10665,10390,8754,-1911
ISNE,"4/5/2022 6 a.m. EDT",11289,11240,9237,-2052
ISNE,"4/5/2022 7 a.m. EDT",12754,12780,11084,-1670
ISNE,"4/5/2022 8 a.m. EDT",13127,13300,11412,-1715
ISNE,"4/5/2022 9 a.m. EDT",12160,12520,10605,-1555
ISNE,"4/5/2022 10 a.m. EDT",11082,11040,9659,-1423
ISNE,"4/5/2022 11 a.m. EDT",10686,10560,9030,-1656
ISNE,"4/5/2022 12 p.m. EDT",10626,10520,9087,-1539
ISNE,"4/5/2022 1 p.m. EDT",10642,10620,9198,-1444
ISNE,"4/5/2022 2 p.m. EDT",10700,9980,8827,-1873
ISNE,"4/5/2022 3 p.m. EDT",10677,10340,8940,-1737
ISNE,"4/5/2022 4 p.m. EDT",10927,10930,9000,-1927
ISNE,"4/5/2022 5 p.m. EDT",11492,11710,9406,-2086
ISNE,"4/5/2022 6 p.m. EDT",11961,12600,9689,-2272
ISNE,"4/5/2022 7 p.m. EDT",12931,13430,10937,-1994
ISNE,"4/5/2022 8 p.m. EDT",13534,13920,11716,-1818
ISNE,"4/5/2022 9 p.m. EDT",13331,13600,11464,-1867
ISNE,"4/5/2022 10 p.m. EDT",12547,12760,10520,-2027
ISNE,"4/5/2022 11 p.m. EDT",11500,11680,9758,-1742
ISNE,"4/6/2022 12 a.m. EDT",10605,10780,8912,-1693
ISNE,"4/6/2022 1 a.m. EDT",10510,10250,8374,-2136
ISNE,"4/6/2022 2 a.m. EDT",10570,9950,8208,-2362
ISNE,"4/6/2022 3 a.m. EDT",10571,9770,8272,-2299
ISNE,"4/6/2022 4 a.m. EDT",10448,9820,8321,-2127
ISNE,"4/6/2022 5 a.m. EDT",10736,10060,8582,-2154
ISNE,"4/6/2022 6 a.m. EDT",10831,10970,8831,-2000
ISNE,"4/6/2022 7 a.m. EDT",12250,12360,10256,-1994
ISNE,"4/6/2022 8 a.m. EDT",13157,13180,11285,-1872
ISNE,"4/6/2022 9 a.m. EDT",13381,13280,11786,-1595
ISNE,"4/6/2022 10 a.m. EDT",13332,13270,11704,-1628
ISNE,"4/6/2022 11 a.m. EDT",13262,13300,11532,-1730
ISNE,"4/6/2022 12 p.m. EDT",13182,13240,11394,-1788
ISNE,"4/6/2022 1 p.m. EDT",12920,12960,11027,-1893
ISNE,"4/6/2022 2 p.m. EDT",12902,12980,11145,-1757
ISNE,"4/6/2022 3 p.m. EDT",12966,13100,11116,-1850
ISNE,"4/6/2022 4 p.m. EDT",12943,13200,10984,-1959
ISNE,"4/6/2022 5 p.m. EDT",13151,13540,11297,-1854
ISNE,"4/6/2022 6 p.m. EDT",13548,13970,11908,-1640
ISNE,"4/6/2022 7 p.m. EDT",13801,14120,12068,-1733
ISNE,"4/6/2022 8 p.m. EDT",14011,14290,12474,-1537
ISNE,"4/6/2022 9 p.m. EDT",13743,13870,12296,-1447
ISNE,"4/6/2022 10 p.m. EDT",12922,13020,11263,-1659
ISNE,"4/6/2022 11 p.m. EDT",11829,11940,10216,-1613
ISNE,"4/7/2022 12 a.m. EDT",10918,11030,9311,-1607
ISNE,"4/7/2022 1 a.m. EDT",10374,10430,8623,-1751
ISNE,"4/7/2022 2 a.m. EDT",10539,10160,8685,-1854
ISNE,"4/7/2022 3 a.m. EDT",10509,9910,8609,-1900
ISNE,"4/7/2022 4 a.m. EDT",10510,9940,8560,-1950
ISNE,"4/7/2022 5 a.m. EDT",10811,10260,8772,-2039
ISNE,"4/7/2022 6 a.m. EDT",11368,11130,9382,-1986
ISNE,"4/7/2022 7 a.m. EDT",12475,12540,10551,-1924
ISNE,"4/7/2022 8 a.m. EDT",13298,13380,11505,-1793
ISNE,"4/7/2022 9 a.m. EDT",13405,13360,11736,-1669
ISNE,"4/7/2022 10 a.m. EDT",13229,13210,11496,-1733
ISNE,"4/7/2022 11 a.m. EDT",13109,12940,11368,-1741
ISNE,"4/7/2022 12 p.m. EDT",12986,12670,11339,-1647
ISNE,"4/7/2022 1 p.m. EDT",12878,12410,11256,-1622
ISNE,"4/7/2022 2 p.m. EDT",12911,12370,11204,-1707
ISNE,"4/7/2022 3 p.m. EDT",13039,12420,11306,-1733
ISNE,"4/7/2022 4 p.m. EDT",13080,12670,11466,-1614
ISNE,"4/7/2022 5 p.m. EDT",13445,13280,11632,-1813
ISNE,"4/7/2022 6 p.m. EDT",13987,13820,12089,-1898
ISNE,"4/7/2022 7 p.m. EDT",14143,14060,12269,-1874
ISNE,"4/7/2022 8 p.m. EDT",14242,14330,12396,-1846
ISNE,"4/7/2022 9 p.m. EDT",13902,13900,12118,-1784
ISNE,"4/7/2022 10 p.m. EDT",13063,13160,11243,-1820
ISNE,"4/7/2022 11 p.m. EDT",12021,12070,10122,-1899
ISNE,"4/8/2022 12 a.m. EDT",11082,11170,8945,-2137
ISNE,"4/8/2022 1 a.m. EDT",10671,10500,8498,-2173
ISNE,"4/8/2022 2 a.m. EDT",10668,10140,8394,-2274
ISNE,"4/8/2022 3 a.m. EDT",10557,9980,8362,-2195
ISNE,"4/8/2022 4 a.m. EDT",10536,9960,8310,-2226
ISNE,"4/8/2022 5 a.m. EDT",10765,10210,8651,-2114
ISNE,"4/8/2022 6 a.m. EDT",11141,10990,9088,-2053
ISNE,"4/8/2022 7 a.m. EDT",12308,12350,10176,-2132
ISNE,"4/8/2022 8 a.m. EDT",13181,13190,11113,-2068
ISNE,"4/8/2022 9 a.m. EDT",13280,13290,11355,-1925
ISNE,"4/8/2022 10 a.m. EDT",12981,12980,10825,-2156
ISNE,"4/8/2022 11 a.m. EDT",12509,12020,10238,-2271
ISNE,"4/8/2022 12 p.m. EDT",11910,10960,9624,-2286
ISNE,"4/8/2022 1 p.m. EDT",11609,10440,9359,-2250
ISNE,"4/8/2022 2 p.m. EDT",11386,10340,9295,-2091
ISNE,"4/8/2022 3 p.m. EDT",11509,10490,9446,-2063
ISNE,"4/8/2022 4 p.m. EDT",11601,10630,9391,-2210
ISNE,"4/8/2022 5 p.m. EDT",11580,11010,9254,-2326
ISNE,"4/8/2022 6 p.m. EDT",11960,12020,9588,-2372
ISNE,"4/8/2022 7 p.m. EDT",12457,12680,10146,-2311
ISNE,"4/8/2022 8 p.m. EDT",12893,13100,10595,-2298
ISNE,"4/8/2022 9 p.m. EDT",12835,12860,10717,-2118
ISNE,"4/8/2022 10 p.m. EDT",12233,12250,9950,-2283
ISNE,"4/8/2022 11 p.m. EDT",11470,11400,9355,-2115
ISNE,"4/9/2022 12 a.m. EDT",10913,10580,9112,-1801
ISNE,"4/9/2022 1 a.m. EDT",10091,10020,8333,-1758
ISNE,"4/9/2022 2 a.m. EDT",10027,9660,8194,-1833
ISNE,"4/9/2022 3 a.m. EDT",9867,9460,8005,-1862
ISNE,"4/9/2022 4 a.m. EDT",9778,9390,7789,-1989
ISNE,"4/9/2022 5 a.m. EDT",9873,9560,7956,-1917
ISNE,"4/9/2022 6 a.m. EDT",10090,9890,8350,-1740
ISNE,"4/9/2022 7 a.m. EDT",10470,10460,8860,-1610
ISNE,"4/9/2022 8 a.m. EDT",11003,10850,9265,-1738
ISNE,"4/9/2022 9 a.m. EDT",11392,11080,9682,-1710
ISNE,"4/9/2022 10 a.m. EDT",11380,11030,10150,-1230
ISNE,"4/9/2022 11 a.m. EDT",11292,10620,9771,-1521
ISNE,"4/9/2022 12 p.m. EDT",11098,10380,9672,-1426
ISNE,"4/9/2022 1 p.m. EDT",10933,10200,9610,-1323
ISNE,"4/9/2022 2 p.m. EDT",10885,10120,9447,-1438
ISNE,"4/9/2022 3 p.m. EDT",10890,10110,9417,-1473
ISNE,"4/9/2022 4 p.m. EDT",10645,10430,9064,-1581
ISNE,"4/9/2022 5 p.m. EDT",10840,11010,9232,-1608
ISNE,"4/9/2022 6 p.m. EDT",11453,11660,9823,-1630
ISNE,"4/9/2022 7 p.m. EDT",12094,12160,10544,-1550
ISNE,"4/9/2022 8 p.m. EDT",12553,12650,10973,-1580
ISNE,"4/9/2022 9 p.m. EDT",12539,12350,11118,-1421
ISNE,"4/9/2022 10 p.m. EDT",12017,12010,10361,-1656
ISNE,"4/9/2022 11 p.m. EDT",11329,11260,9760,-1569
ISNE,"4/10/2022 12 a.m. EDT",10629,10570,8838,-1791
ISNE,"4/10/2022 1 a.m. EDT",10095,9940,8475,-1620
ISNE,"4/10/2022 2 a.m. EDT",10010,9630,8571,-1439
ISNE,"4/10/2022 3 a.m. EDT",10018,9480,8429,-1589
ISNE,"4/10/2022 4 a.m. EDT",10086,9560,8536,-1550
ISNE,"4/10/2022 5 a.m. EDT",10171,9690,8683,-1488
ISNE,"4/10/2022 6 a.m. EDT",10164,10080,8634,-1530
ISNE,"4/10/2022 7 a.m. EDT",10299,10350,8616,-1683
ISNE,"4/10/2022 8 a.m. EDT",10474,10510,8739,-1735
ISNE,"4/10/2022 9 a.m. EDT",10410,10360,8878,-1532
ISNE,"4/10/2022 10 a.m. EDT",10187,10030,8855,-1332
ISNE,"4/10/2022 11 a.m. EDT",9899,9900,8904,-995
ISNE,"4/10/2022 12 p.m. EDT",10045,9890,9266,-779
ISNE,"4/10/2022 1 p.m. EDT",10299,9910,9337,-962
ISNE,"4/10/2022 2 p.m. EDT",10581,10020,9411,-1170
ISNE,"4/10/2022 3 p.m. EDT",10571,10110,9416,-1155
ISNE,"4/10/2022 4 p.m. EDT",10900,10450,9732,-1168
ISNE,"4/10/2022 5 p.m. EDT",11192,11160,10079,-1113
ISNE,"4/10/2022 6 p.m. EDT",12064,12190,10904,-1160
ISNE,"4/10/2022 7 p.m. EDT",12833,12830,11474,-1359
ISNE,"4/10/2022 8 p.m. EDT",13295,13250,11812,-1483
ISNE,"4/10/2022 9 p.m. EDT",13138,13070,11609,-1529
ISNE,"4/10/2022 10 p.m. EDT",12424,12380,10657,-1767
ISNE,"4/10/2022 11 p.m. EDT",11491,11450,9844,-1647
ISNE,"4/11/2022 12 a.m. EDT",10750,10660,8995,-1755
ISNE,"4/11/2022 1 a.m. EDT",10413,10120,8537,-1876
ISNE,"4/11/2022 2 a.m. EDT",10135,9860,8236,-1899
ISNE,"4/11/2022 3 a.m. EDT",10027,9780,8272,-1755
ISNE,"4/11/2022 4 a.m. EDT",10352,9820,8633,-1719
ISNE,"4/11/2022 5 a.m. EDT",10537,10220,8749,-1788
ISNE,"4/11/2022 6 a.m. EDT",11131,11190,9569,-1562
ISNE,"4/11/2022 7 a.m. EDT",12517,12600,11202,-1315
ISNE,"4/11/2022 8 a.m. EDT",12860,12920,11493,-1367
ISNE,"4/11/2022 9 a.m. EDT",11953,12070,10442,-1511
ISNE,"4/11/2022 10 a.m. EDT",10974,10910,9362,-1612
ISNE,"4/11/2022 11 a.m. EDT",10372,10150,8657,-1715
ISNE,"4/11/2022 12 p.m. EDT",9972,9790,8398,-1574
ISNE,"4/11/2022 1 p.m. EDT",10017,9660,8211,-1806
ISNE,"4/11/2022 2 p.m. EDT",10050,9590,8207,-1843
ISNE,"4/11/2022 3 p.m. EDT",10047,9630,8447,-1600
ISNE,"4/11/2022 4 p.m. EDT",10518,9800,8847,-1671
ISNE,"4/11/2022 5 p.m. EDT",10996,10730,9205,-1791
ISNE,"4/11/2022 6 p.m. EDT",11707,12120,9961,-1746
ISNE,"4/11/2022 7 p.m. EDT",12682,13060,10869,-1813
ISNE,"4/11/2022 8 p.m. EDT",13281,13600,11456,-1825
ISNE,"4/11/2022 9 p.m. EDT",13173,13380,11270,-1903
ISNE,"4/11/2022 10 p.m. EDT",12370,12610,10549,-1821
ISNE,"4/11/2022 11 p.m. EDT",11318,11590,9539,-1779
ISNE,"4/12/2022 12 a.m. EDT",10409,10680,8623,-1786
ISNE,"4/12/2022 1 a.m. EDT",9784,9860,7963,-1821
ISNE,"4/12/2022 2 a.m. EDT",9755,9520,7842,-1913
ISNE,"4/12/2022 3 a.m. EDT",9825,9340,7922,-1903
ISNE,"4/12/2022 4 a.m. EDT",9845,9350,8005,-1840
ISNE,"4/12/2022 5 a.m. EDT",10127,9660,8242,-1885
ISNE,"4/12/2022 6 a.m. EDT",10537,10540,9026,-1511
ISNE,"4/12/2022 7 a.m. EDT",11739,12040,10526,-1213
ISNE,"4/12/2022 8 a.m. EDT",12689,12790,11576,-1113
ISNE,"4/12/2022 9 a.m. EDT",13058,12810,11528,-1530
ISNE,"4/12/2022 10 a.m. EDT",13222,13130,11742,-1480
ISNE,"4/12/2022 11 a.m. EDT",13217,12700,11466,-1751
ISNE,"4/12/2022 12 p.m. EDT",12653,12030,10635,-2018
ISNE,"4/12/2022 1 p.m. EDT",11428,11180,9528,-1900
ISNE,"4/12/2022 2 p.m. EDT",10455,10600,9021,-1434
ISNE,"4/12/2022 3 p.m. EDT",10429,10230,9298,-1131
ISNE,"4/12/2022 4 p.m. EDT",10510,10170,9406,-1104
ISNE,"4/12/2022 5 p.m. EDT",11083,10940,9909,-1174
ISNE,"4/12/2022 6 p.m. EDT",11760,12070,10644,-1116
ISNE,"4/12/2022 7 p.m. EDT",12712,12870,11310,-1402
ISNE,"4/12/2022 8 p.m. EDT",13215,13380,11600,-1615
ISNE,"4/12/2022 9 p.m. EDT",13114,13190,11540,-1574
ISNE,"4/12/2022 10 p.m. EDT",12282,12390,10743,-1539
ISNE,"4/12/2022 11 p.m. EDT",11222,11360,9782,-1440
ISNE,"4/13/2022 12 a.m. EDT",10617,10410,8996,-1621
ISNE,"4/13/2022 1 a.m. EDT",10565,9660,8921,-1644
ISNE,"4/13/2022 2 a.m. EDT",10490,9340,8936,-1554
ISNE,"4/13/2022 3 a.m. EDT",10335,9160,8854,-1481
ISNE,"4/13/2022 4 a.m. EDT",10323,9200,8778,-1545
ISNE,"4/13/2022 5 a.m. EDT",10370,9520,8741,-1629
ISNE,"4/13/2022 6 a.m. EDT",10742,10300,9176,-1566
ISNE,"4/13/2022 7 a.m. EDT",11668,11620,9948,-1720
ISNE,"4/13/2022 8 a.m. EDT",12092,12110,10087,-2005
ISNE,"4/13/2022 9 a.m. EDT",11616,11690,9586,-2030
ISNE,"4/13/2022 10 a.m. EDT",10913,11160,9112,-1801
ISNE,"4/13/2022 11 a.m. EDT",10346,10490,8846,-1500
ISNE,"4/13/2022 12 p.m. EDT",10260,10180,8848,-1412
ISNE,"4/13/2022 1 p.m. EDT",10365,10300,9071,-1294
ISNE,"4/13/2022 2 p.m. EDT",10659,10350,9438,-1221
ISNE,"4/13/2022 3 p.m. EDT",10652,10450,9212,-1440
ISNE,"4/13/2022 4 p.m. EDT",10763,10740,9491,-1272
ISNE,"4/13/2022 5 p.m. EDT",11237,11370,9990,-1247
ISNE,"4/13/2022 6 p.m. EDT",12164,12270,10783,-1381
ISNE,"4/13/2022 7 p.m. EDT",12820,12920,11230,-1590
ISNE,"4/13/2022 8 p.m. EDT",13191,13200,11629,-1562
ISNE,"4/13/2022 9 p.m. EDT",13063,13040,11673,-1390
ISNE,"4/13/2022 10 p.m. EDT",12262,12260,10781,-1481
ISNE,"4/13/2022 11 p.m. EDT",11247,11210,9341,-1906
ISNE,"4/14/2022 12 a.m. EDT",10528,10340,8696,-1832
ISNE,"4/14/2022 1 a.m. EDT",10177,9610,8451,-1726
ISNE,"4/14/2022 2 a.m. EDT",10289,9230,8596,-1693
ISNE,"4/14/2022 3 a.m. EDT",10121,9020,8412,-1709
ISNE,"4/14/2022 4 a.m. EDT",10053,9000,8391,-1662
ISNE,"4/14/2022 5 a.m. EDT",9865,9290,8376,-1489
ISNE,"4/14/2022 6 a.m. EDT",10415,10130,8954,-1461
ISNE,"4/14/2022 7 a.m. EDT",11298,11580,10034,-1264
ISNE,"4/14/2022 8 a.m. EDT",12047,12260,10815,-1232
ISNE,"4/14/2022 9 a.m. EDT",12085,12210,10926,-1159
ISNE,"4/14/2022 10 a.m. EDT",11916,11780,10711,-1205
ISNE,"4/14/2022 11 a.m. EDT",11640,11370,10424,-1216
ISNE,"4/14/2022 12 p.m. EDT",11275,11060,10216,-1059
ISNE,"4/14/2022 1 p.m. EDT",10976,10920,9989,-987
ISNE,"4/14/2022 2 p.m. EDT",10816,10890,9762,-1054
ISNE,"4/14/2022 3 p.m. EDT",10768,10950,9638,-1130
ISNE,"4/14/2022 4 p.m. EDT",11091,11250,10049,-1042
ISNE,"4/14/2022 5 p.m. EDT",11912,11930,10832,-1080
ISNE,"4/14/2022 6 p.m. EDT",12980,12730,11912,-1068
ISNE,"4/14/2022 7 p.m. EDT",13399,13150,12268,-1131
ISNE,"4/14/2022 8 p.m. EDT",13432,13400,12354,-1078
ISNE,"4/14/2022 9 p.m. EDT",13066,13180,11886,-1180
ISNE,"4/14/2022 10 p.m. EDT",12308,12370,11029,-1279
ISNE,"4/14/2022 11 p.m. EDT",11308,11300,9897,-1411
ISNE,"4/15/2022 12 a.m. EDT",10406,10370,9034,-1372
ISNE,"4/15/2022 1 a.m. EDT",9754,9750,8192,-1562
ISNE,"4/15/2022 2 a.m. EDT",9358,9350,7765,-1593
ISNE,"4/15/2022 3 a.m. EDT",9464,9140,7713,-1751
ISNE,"4/15/2022 4 a.m. EDT",9421,9120,7635,-1786
ISNE,"4/15/2022 5 a.m. EDT",9327,9330,7659,-1668
ISNE,"4/15/2022 6 a.m. EDT",10014,10100,8200,-1814
ISNE,"4/15/2022 7 a.m. EDT",11033,11150,8930,-2103
ISNE,"4/15/2022 8 a.m. EDT",11460,11260,9537,-1923
ISNE,"4/15/2022 9 a.m. EDT",10740,10550,8922,-1818
ISNE,"4/15/2022 10 a.m. EDT",9870,9680,8453,-1417
ISNE,"4/15/2022 11 a.m. EDT",9550,8840,8352,-1198
ISNE,"4/15/2022 12 p.m. EDT",9527,8700,8273,-1254
ISNE,"4/15/2022 1 p.m. EDT",9655,8580,8424,-1231
ISNE,"4/15/2022 2 p.m. EDT",9612,8580,8458,-1154
ISNE,"4/15/2022 3 p.m. EDT",9607,8630,8475,-1132
ISNE,"4/15/2022 4 p.m. EDT",9641,8920,8544,-1097
ISNE,"4/15/2022 5 p.m. EDT",10041,9690,8982,-1059
ISNE,"4/15/2022 6 p.m. EDT",11049,10890,9762,-1287
ISNE,"4/15/2022 7 p.m. EDT",11834,11810,10323,-1511
ISNE,"4/15/2022 8 p.m. EDT",12250,12440,10642,-1608
ISNE,"4/15/2022 9 p.m. EDT",12231,12390,10631,-1600
ISNE,"4/15/2022 10 p.m. EDT",11661,11740,9928,-1733
ISNE,"4/15/2022 11 p.m. EDT",10875,10940,9162,-1713
ISNE,"4/16/2022 12 a.m. EDT",10090,10160,8442,-1648
ISNE,"4/16/2022 1 a.m. EDT",9456,9680,8039,-1417
ISNE,"4/16/2022 2 a.m. EDT",9383,9270,7913,-1470
ISNE,"4/16/2022 3 a.m. EDT",9162,9060,7765,-1397
ISNE,"4/16/2022 4 a.m. EDT",9087,8930,7328,-1759
ISNE,"4/16/2022 5 a.m. EDT",9166,8910,7596,-1570
ISNE,"4/16/2022 6 a.m. EDT",9219,9120,7412,-1807
ISNE,"4/16/2022 7 a.m. EDT",9579,9550,7778,-1801
ISNE,"4/16/2022 8 a.m. EDT",10036,10020,8505,-1531
ISNE,"4/16/2022 9 a.m. EDT",10532,10220,9059,-1473
ISNE,"4/16/2022 10 a.m. EDT",10884,10830,9373,-1511
ISNE,"4/16/2022 11 a.m. EDT",10858,10930,9394,-1464
ISNE,"4/16/2022 12 p.m. EDT",10428,10200,8845,-1583
ISNE,"4/16/2022 1 p.m. EDT",9964,10120,8279,-1685
ISNE,"4/16/2022 2 p.m. EDT",9799,10130,8183,-1616
ISNE,"4/16/2022 3 p.m. EDT",10050,10140,8452,-1598
ISNE,"4/16/2022 4 p.m. EDT",10320,10510,8919,-1401
ISNE,"4/16/2022 5 p.m. EDT",10998,10910,9380,-1618
ISNE,"4/16/2022 6 p.m. EDT",11770,11440,9956,-1814
ISNE,"4/16/2022 7 p.m. EDT",12195,12000,10470,-1725
ISNE,"4/16/2022 8 p.m. EDT",12313,12360,10624,-1689
ISNE,"4/16/2022 9 p.m. EDT",12070,12090,10454,-1616
ISNE,"4/16/2022 10 p.m. EDT",11533,11630,9784,-1749
ISNE,"4/16/2022 11 p.m. EDT",10822,10890,8928,-1894
ISNE,"4/17/2022 12 a.m. EDT",10136,10150,8156,-1980
ISNE,"4/17/2022 1 a.m. EDT",9563,9750,7848,-1715
ISNE,"4/17/2022 2 a.m. EDT",9512,9430,7773,-1739
ISNE,"4/17/2022 3 a.m. EDT",9322,9240,7581,-1741
ISNE,"4/17/2022 4 a.m. EDT",9260,8980,7579,-1681
ISNE,"4/17/2022 5 a.m. EDT",9331,9080,7636,-1695
ISNE,"4/17/2022 6 a.m. EDT",9295,9380,7533,-1762
ISNE,"4/17/2022 7 a.m. EDT",9655,9830,7881,-1774
ISNE,"4/17/2022 8 a.m. EDT",9796,10110,8103,-1693
ISNE,"4/17/2022 9 a.m. EDT",9620,9700,8082,-1538
ISNE,"4/17/2022 10 a.m. EDT",9701,9600,8209,-1492
ISNE,"4/17/2022 11 a.m. EDT",10044,9640,8643,-1401
ISNE,"4/17/2022 12 p.m. EDT",10530,9700,9256,-1274
ISNE,"4/17/2022 1 p.m. EDT",10324,9800,9023,-1301
ISNE,"4/17/2022 2 p.m. EDT",10138,9770,8698,-1440
ISNE,"4/17/2022 3 p.m. EDT",10039,9980,8572,-1467
ISNE,"4/17/2022 4 p.m. EDT",9891,10480,8453,-1438
ISNE,"4/17/2022 5 p.m. EDT",10137,9570,8725,-1412
ISNE,"4/17/2022 6 p.m. EDT",10773,11150,9104,-1669
ISNE,"4/17/2022 7 p.m. EDT",11282,12270,9448,-1834
ISNE,"4/17/2022 8 p.m. EDT",12084,13130,10453,-1631
ISNE,"4/17/2022 9 p.m. EDT",12379,12940,10782,-1597
ISNE,"4/17/2022 10 p.m. EDT",11911,12240,10404,-1507
ISNE,"4/17/2022 11 p.m. EDT",11173,11320,9579,-1594
ISNE,"4/18/2022 12 a.m. EDT",10469,10510,8901,-1568
ISNE,"4/18/2022 1 a.m. EDT",10244,9990,8587,-1657
ISNE,"4/18/2022 2 a.m. EDT",10313,9730,8508,-1805
ISNE,"4/18/2022 3 a.m. EDT",10231,9640,8485,-1746
ISNE,"4/18/2022 4 a.m. EDT",10305,9740,8699,-1606
ISNE,"4/18/2022 5 a.m. EDT",10655,10090,8962,-1693
ISNE,"4/18/2022 6 a.m. EDT",11027,10950,9202,-1825
ISNE,"4/18/2022 7 a.m. EDT",11901,11990,10414,-1487
ISNE,"4/18/2022 8 a.m. EDT",12079,12140,10782,-1297
ISNE,"4/18/2022 9 a.m. EDT",11299,11310,10107,-1192
ISNE,"4/18/2022 10 a.m. EDT",10362,10300,9367,-995
ISNE,"4/18/2022 11 a.m. EDT",9772,9650,8796,-976
ISNE,"4/18/2022 12 p.m. EDT",9476,9380,8616,-860
ISNE,"4/18/2022 1 p.m. EDT",9649,9310,8684,-965
ISNE,"4/18/2022 2 p.m. EDT",10026,9290,9101,-925
ISNE,"4/18/2022 3 p.m. EDT",9922,9510,9207,-715
ISNE,"4/18/2022 4 p.m. EDT",10288,10010,9677,-611
ISNE,"4/18/2022 5 p.m. EDT",11304,11250,10498,-806
ISNE,"4/18/2022 6 p.m. EDT",12285,12330,11302,-983
ISNE,"4/18/2022 7 p.m. EDT",13015,13010,11839,-1176
ISNE,"4/18/2022 8 p.m. EDT",13453,13460,12166,-1287
ISNE,"4/18/2022 9 p.m. EDT",13243,13270,12032,-1211
ISNE,"4/18/2022 10 p.m. EDT",12492,12480,11479,-1013
ISNE,"4/18/2022 11 p.m. EDT",11518,11480,10047,-1471
ISNE,"4/19/2022 12 a.m. EDT",10695,10580,9458,-1237
ISNE,"4/19/2022 1 a.m. EDT",10445,10110,9010,-1435
ISNE,"4/19/2022 2 a.m. EDT",10150,9820,8634,-1516
ISNE,"4/19/2022 3 a.m. EDT",10030,9710,8418,-1612
ISNE,"4/19/2022 4 a.m. EDT",10084,9780,8401,-1683
ISNE,"4/19/2022 5 a.m. EDT",10401,10110,8743,-1658
ISNE,"4/19/2022 6 a.m. EDT",10806,10830,9506,-1300
ISNE,"4/19/2022 7 a.m. EDT",11948,11980,10815,-1133
ISNE,"4/19/2022 8 a.m. EDT",12860,12870,11726,-1134
ISNE,"4/19/2022 9 a.m. EDT",13141,13150,12069,-1072
ISNE,"4/19/2022 10 a.m. EDT",12929,12850,11914,-1015
ISNE,"4/19/2022 11 a.m. EDT",12588,12430,11461,-1127
ISNE,"4/19/2022 12 p.m. EDT",12081,12010,10972,-1109
ISNE,"4/19/2022 1 p.m. EDT",11838,11490,10731,-1107
ISNE,"4/19/2022 2 p.m. EDT",11759,11310,10653,-1106
ISNE,"4/19/2022 3 p.m. EDT",11427,11350,10325,-1102
ISNE,"4/19/2022 4 p.m. EDT",11571,11360,10557,-1014
ISNE,"4/19/2022 5 p.m. EDT",12169,11880,11105,-1064
ISNE,"4/19/2022 6 p.m. EDT",12737,12580,11623,-1114
ISNE,"4/19/2022 7 p.m. EDT",13244,13250,12062,-1182
ISNE,"4/19/2022 8 p.m. EDT",13610,13760,12389,-1221
ISNE,"4/19/2022 9 p.m. EDT",13566,13630,12462,-1104
ISNE,"4/19/2022 10 p.m. EDT",12854,12750,11288,-1566
ISNE,"4/19/2022 11 p.m. EDT",11885,11710,10460,-1425
ISNE,"4/20/2022 12 a.m. EDT",11003,10790,9597,-1406
ISNE,"4/20/2022 1 a.m. EDT",10413,10410,8996,-1417
ISNE,"4/20/2022 2 a.m. EDT",10397,10070,8954,-1443
ISNE,"4/20/2022 3 a.m. EDT",10234,9920,8896,-1338
ISNE,"4/20/2022 4 a.m. EDT",10429,9940,8930,-1499
ISNE,"4/20/2022 5 a.m. EDT",10518,10250,9229,-1289
ISNE,"4/20/2022 6 a.m. EDT",11210,11070,9921,-1289
ISNE,"4/20/2022 7 a.m. EDT",12094,12110,10874,-1220
ISNE,"4/20/2022 8 a.m. EDT",12429,12420,11229,-1200
ISNE,"4/20/2022 9 a.m. EDT",11986,11970,10639,-1347
ISNE,"4/20/2022 10 a.m. EDT",11423,11430,10009,-1414
ISNE,"4/20/2022 11 a.m. EDT",10906,10700,9485,-1421
ISNE,"4/20/2022 12 p.m. EDT",10677,10330,9190,-1487
ISNE,"4/20/2022 1 p.m. EDT",10119,9930,8718,-1401
ISNE,"4/20/2022 2 p.m. EDT",9856,9660,8635,-1221
ISNE,"4/20/2022 3 p.m. EDT",10088,9430,8866,-1222
ISNE,"4/20/2022 4 p.m. EDT",10358,9610,9039,-1319
ISNE,"4/20/2022 5 p.m. EDT",10641,10660,9390,-1251
ISNE,"4/20/2022 6 p.m. EDT",11529,11900,10126,-1403
ISNE,"4/20/2022 7 p.m. EDT",12577,12880,10955,-1622
ISNE,"4/20/2022 8 p.m. EDT",13138,13440,11382,-1756
ISNE,"4/20/2022 9 p.m. EDT",13204,13420,11492,-1712
ISNE,"4/20/2022 10 p.m. EDT",12557,12680,11114,-1443
ISNE,"4/20/2022 11 p.m. EDT",11647,11660,9998,-1649
ISNE,"4/21/2022 12 a.m. EDT",10775,10740,9097,-1678
ISNE,"4/21/2022 1 a.m. EDT",10474,10200,8755,-1719
ISNE,"4/21/2022 2 a.m. EDT",10566,9930,8531,-2035
ISNE,"4/21/2022 3 a.m. EDT",10438,9780,8540,-1898
ISNE,"4/21/2022 4 a.m. EDT",10733,9880,8761,-1972
ISNE,"4/21/2022 5 a.m. EDT",10770,10270,8888,-1882
ISNE,"4/21/2022 6 a.m. EDT",11209,11100,9629,-1580
ISNE,"4/21/2022 7 a.m. EDT",12078,12150,10768,-1310
ISNE,"4/21/2022 8 a.m. EDT",12239,12290,10985,-1254
ISNE,"4/21/2022 9 a.m. EDT",11572,11500,10445,-1127
ISNE,"4/21/2022 10 a.m. EDT",10810,10620,9699,-1111
ISNE,"4/21/2022 11 a.m. EDT",10225,10260,9128,-1097
ISNE,"4/21/2022 12 p.m. EDT",10161,10020,9030,-1131
ISNE,"4/21/2022 1 p.m. EDT",10129,9910,8986,-1143
ISNE,"4/21/2022 2 p.m. EDT",10753,9890,9504,-1249
ISNE,"4/21/2022 3 p.m. EDT",10726,10400,9502,-1224
ISNE,"4/21/2022 4 p.m. EDT",11383,10400,10146,-1237
ISNE,"4/21/2022 5 p.m. EDT",11871,11840,10651,-1220
ISNE,"4/21/2022 6 p.m. EDT",12721,12640,11446,-1275
ISNE,"4/21/2022 7 p.m. EDT",13140,13050,11875,-1265
ISNE,"4/21/2022 8 p.m. EDT",13343,13350,12043,-1300
ISNE,"4/21/2022 9 p.m. EDT",13148,13280,11877,-1271
ISNE,"4/21/2022 10 p.m. EDT",12392,12510,11016,-1376
ISNE,"4/21/2022 11 p.m. EDT",11387,11440,9827,-1560
ISNE,"4/22/2022 12 a.m. EDT",10512,10530,8865,-1647
ISNE,"4/22/2022 1 a.m. EDT",10190,9940,8405,-1785
ISNE,"4/22/2022 2 a.m. EDT",9842,9560,8162,-1680
ISNE,"4/22/2022 3 a.m. EDT",9725,9400,8039,-1686
ISNE,"4/22/2022 4 a.m. EDT",9716,9410,7929,-1787
ISNE,"4/22/2022 5 a.m. EDT",9959,9680,7969,-1990
ISNE,"4/22/2022 6 a.m. EDT",10391,10390,8532,-1859
ISNE,"4/22/2022 7 a.m. EDT",11360,11360,9439,-1921
ISNE,"4/22/2022 8 a.m. EDT",11786,11750,10205,-1581
ISNE,"4/22/2022 9 a.m. EDT",11232,11130,9582,-1650
ISNE,"4/22/2022 10 a.m. EDT",10636,10300,9306,-1330
ISNE,"4/22/2022 11 a.m. EDT",10253,9840,9067,-1186
ISNE,"4/22/2022 12 p.m. EDT",9939,9610,8627,-1312
ISNE,"4/22/2022 1 p.m. EDT",9652,9390,8438,-1214
ISNE,"4/22/2022 2 p.m. EDT",9725,9340,8619,-1106
ISNE,"4/22/2022 3 p.m. EDT",9690,9330,8317,-1373
ISNE,"4/22/2022 4 p.m. EDT",9860,9620,8744,-1116
ISNE,"4/22/2022 5 p.m. EDT",10246,10520,8902,-1344
ISNE,"4/22/2022 6 p.m. EDT",11059,11510,9742,-1317
ISNE,"4/22/2022 7 p.m. EDT",11941,12230,10674,-1267
ISNE,"4/22/2022 8 p.m. EDT",12375,12600,10889,-1486
ISNE,"4/22/2022 9 p.m. EDT",12457,12640,10803,-1654
ISNE,"4/22/2022 10 p.m. EDT",11900,12070,10150,-1750
ISNE,"4/22/2022 11 p.m. EDT",11090,11250,9403,-1687
ISNE,"4/23/2022 12 a.m. EDT",10318,10440,8373,-1945
ISNE,"4/23/2022 1 a.m. EDT",9739,9790,7984,-1755
ISNE,"4/23/2022 2 a.m. EDT",9370,9470,7893,-1477
ISNE,"4/23/2022 3 a.m. EDT",9487,9300,8014,-1473
ISNE,"4/23/2022 4 a.m. EDT",9450,9240,7884,-1566
ISNE,"4/23/2022 5 a.m. EDT",9310,9470,7745,-1565
ISNE,"4/23/2022 6 a.m. EDT",9679,9790,8089,-1590
ISNE,"4/23/2022 7 a.m. EDT",10049,10160,8453,-1596
ISNE,"4/23/2022 8 a.m. EDT",10062,10340,8673,-1389
ISNE,"4/23/2022 9 a.m. EDT",9714,9930,8613,-1101
ISNE,"4/23/2022 10 a.m. EDT",9351,9470,8267,-1084
ISNE,"4/23/2022 11 a.m. EDT",9315,9070,8217,-1098
ISNE,"4/23/2022 12 p.m. EDT",9279,8840,8179,-1100
ISNE,"4/23/2022 1 p.m. EDT",9088,8660,7908,-1180
ISNE,"4/23/2022 2 p.m. EDT",9138,8640,7901,-1237
ISNE,"4/23/2022 3 p.m. EDT",9598,8560,8368,-1230
ISNE,"4/23/2022 4 p.m. EDT",10093,9320,8867,-1226
ISNE,"4/23/2022 5 p.m. EDT",10559,10270,9277,-1282
ISNE,"4/23/2022 6 p.m. EDT",11419,11200,10008,-1411
ISNE,"4/23/2022 7 p.m. EDT",11646,11840,10087,-1559
ISNE,"4/23/2022 8 p.m. EDT",11983,12100,10348,-1635
ISNE,"4/23/2022 9 p.m. EDT",11935,12200,10285,-1650
ISNE,"4/23/2022 10 p.m. EDT",11393,11570,9894,-1499
ISNE,"4/23/2022 11 p.m. EDT",10661,10870,9311,-1350
ISNE,"4/24/2022 12 a.m. EDT",9954,10150,8322,-1632
ISNE,"4/24/2022 1 a.m. EDT",9415,9430,7852,-1563
ISNE,"4/24/2022 2 a.m. EDT",9578,9030,7839,-1739
ISNE,"4/24/2022 3 a.m. EDT",9461,8910,7822,-1639
ISNE,"4/24/2022 4 a.m. EDT",9389,8890,7756,-1633
ISNE,"4/24/2022 5 a.m. EDT",9464,8980,7833,-1631
ISNE,"4/24/2022 6 a.m. EDT",9263,9130,7754,-1509
ISNE,"4/24/2022 7 a.m. EDT",9646,9370,7926,-1720
ISNE,"4/24/2022 8 a.m. EDT",10302,9530,8815,-1487
ISNE,"4/24/2022 9 a.m. EDT",10386,9600,9048,-1338
ISNE,"4/24/2022 10 a.m. EDT",10222,9610,8871,-1351
ISNE,"4/24/2022 11 a.m. EDT",9891,9440,8472,-1419
ISNE,"4/24/2022 12 p.m. EDT",9836,9320,8395,-1441
ISNE,"4/24/2022 1 p.m. EDT",9938,9270,8527,-1411
ISNE,"4/24/2022 2 p.m. EDT",9712,9100,8385,-1327
ISNE,"4/24/2022 3 p.m. EDT",9467,8970,8120,-1347
ISNE,"4/24/2022 4 p.m. EDT",9762,9060,8424,-1338
ISNE,"4/24/2022 5 p.m. EDT",10445,9770,9211,-1234
ISNE,"4/24/2022 6 p.m. EDT",11237,10980,10080,-1157
ISNE,"4/24/2022 7 p.m. EDT",11912,11840,10718,-1194
ISNE,"4/24/2022 8 p.m. EDT",12355,12450,10973,-1382
ISNE,"4/24/2022 9 p.m. EDT",12429,12370,11025,-1404
ISNE,"4/24/2022 10 p.m. EDT",11756,11730,10184,-1572
ISNE,"4/24/2022 11 p.m. EDT",10832,10870,9332,-1500
ISNE,"4/25/2022 12 a.m. EDT",10014,10080,8393,-1621
ISNE,"4/25/2022 1 a.m. EDT",9469,9490,7943,-1526
ISNE,"4/25/2022 2 a.m. EDT",9382,9170,7846,-1536
ISNE,"4/25/2022 3 a.m. EDT",9328,9090,7704,-1624
ISNE,"4/25/2022 4 a.m. EDT",9402,9160,7715,-1687
ISNE,"4/25/2022 5 a.m. EDT",9724,9440,8210,-1514
ISNE,"4/25/2022 6 a.m. EDT",10346,10390,9020,-1326
ISNE,"4/25/2022 7 a.m. EDT",11546,11660,10478,-1068
ISNE,"4/25/2022 8 a.m. EDT",12090,12130,11008,-1082
ISNE,"4/25/2022 9 a.m. EDT",11847,11800,10814,-1033
ISNE,"4/25/2022 10 a.m. EDT",11124,11200,10218,-906
ISNE,"4/25/2022 11 a.m. EDT",10427,10540,9509,-918
ISNE,"4/25/2022 12 p.m. EDT",10507,10310,9533,-974
ISNE,"4/25/2022 1 p.m. EDT",10580,10080,9642,-938
ISNE,"4/25/2022 2 p.m. EDT",10756,10080,9709,-1047
ISNE,"4/25/2022 3 p.m. EDT",10984,9960,9730,-1254
ISNE,"4/25/2022 4 p.m. EDT",10917,10370,9710,-1207
ISNE,"4/25/2022 5 p.m. EDT",11101,11260,10055,-1046
ISNE,"4/25/2022 6 p.m. EDT",11803,12230,10698,-1105
ISNE,"4/25/2022 7 p.m. EDT",12454,12970,11344,-1110
ISNE,"4/25/2022 8 p.m. EDT",12995,13370,11707,-1288
ISNE,"4/25/2022 9 p.m. EDT",13006,13240,11700,-1306
ISNE,"4/25/2022 10 p.m. EDT",12204,12440,10842,-1362
ISNE,"4/25/2022 11 p.m. EDT",11177,11390,9722,-1455
ISNE,"4/26/2022 12 a.m. EDT",10250,10480,8702,-1548
ISNE,"4/26/2022 1 a.m. EDT",9827,9770,7975,-1852
ISNE,"4/26/2022 2 a.m. EDT",9916,9410,8082,-1834
ISNE,"4/26/2022 3 a.m. EDT",9741,9290,7842,-1899
ISNE,"4/26/2022 4 a.m. EDT",9730,9290,7834,-1896
ISNE,"4/26/2022 5 a.m. EDT",9789,9570,8120,-1669
ISNE,"4/26/2022 6 a.m. EDT",10550,10360,8956,-1594
ISNE,"4/26/2022 7 a.m. EDT",11545,11620,10189,-1356
ISNE,"4/26/2022 8 a.m. EDT",12438,12320,11118,-1320
ISNE,"4/26/2022 9 a.m. EDT",12691,12440,11223,-1468
ISNE,"4/26/2022 10 a.m. EDT",12749,12380,11234,-1515
ISNE,"4/26/2022 11 a.m. EDT",12735,12340,11186,-1549
ISNE,"4/26/2022 12 p.m. EDT",12706,12460,11198,-1508
ISNE,"4/26/2022 1 p.m. EDT",12665,12390,11060,-1605
ISNE,"4/26/2022 2 p.m. EDT",12701,12480,11038,-1663
ISNE,"4/26/2022 3 p.m. EDT",12765,12440,11111,-1654
ISNE,"4/26/2022 4 p.m. EDT",12916,12590,11350,-1566
ISNE,"4/26/2022 5 p.m. EDT",13268,13000,11474,-1794
ISNE,"4/26/2022 6 p.m. EDT",13639,13740,11688,-1951
ISNE,"4/26/2022 7 p.m. EDT",13735,13760,11635,-2100
ISNE,"4/26/2022 8 p.m. EDT",13656,13800,11603,-2053
ISNE,"4/26/2022 9 p.m. EDT",13234,13580,11370,-1864
ISNE,"4/26/2022 10 p.m. EDT",12362,12640,10462,-1900
ISNE,"4/26/2022 11 p.m. EDT",11298,11520,9241,-2057
ISNE,"4/27/2022 12 a.m. EDT",10386,10620,8320,-2066
ISNE,"4/27/2022 1 a.m. EDT",9976,9760,7583,-2393
ISNE,"4/27/2022 2 a.m. EDT",9900,9400,7403,-2497
ISNE,"4/27/2022 3 a.m. EDT",9804,9220,7530,-2274
ISNE,"4/27/2022 4 a.m. EDT",9646,9230,7612,-2034
ISNE,"4/27/2022 5 a.m. EDT",9781,9520,7716,-2065
ISNE,"4/27/2022 6 a.m. EDT",10320,10360,8245,-2075
ISNE,"4/27/2022 7 a.m. EDT",11489,11610,9629,-1860
ISNE,"4/27/2022 8 a.m. EDT",12000,12270,10255,-1745
ISNE,"4/27/2022 9 a.m. EDT",11607,12010,9811,-1796
ISNE,"4/27/2022 10 a.m. EDT",11212,11330,9888,-1324
ISNE,"4/27/2022 11 a.m. EDT",11137,10860,10160,-977
ISNE,"4/27/2022 12 p.m. EDT",11307,10560,10452,-855
ISNE,"4/27/2022 1 p.m. EDT",11282,10500,10027,-1255
ISNE,"4/27/2022 2 p.m. EDT",11274,10630,10075,-1199
ISNE,"4/27/2022 3 p.m. EDT",11123,10730,10178,-945
ISNE,"4/27/2022 4 p.m. EDT",11542,10930,10340,-1202
ISNE,"4/27/2022 5 p.m. EDT",11746,11360,10643,-1103
ISNE,"4/27/2022 6 p.m. EDT",12333,12310,10956,-1377
ISNE,"4/27/2022 7 p.m. EDT",12879,13030,11385,-1494
ISNE,"4/27/2022 8 p.m. EDT",13333,13500,11904,-1429
ISNE,"4/27/2022 9 p.m. EDT",13411,13460,11965,-1446
ISNE,"4/27/2022 10 p.m. EDT",12712,12730,11381,-1331
ISNE,"4/27/2022 11 p.m. EDT",11715,11690,10453,-1262
ISNE,"4/28/2022 12 a.m. EDT",10845,10760,9390,-1455
ISNE,"4/28/2022 1 a.m. EDT",10273,10250,9082,-1191
ISNE,"4/28/2022 2 a.m. EDT",10392,9950,9153,-1239
ISNE,"4/28/2022 3 a.m. EDT",10384,9820,9122,-1262
ISNE,"4/28/2022 4 a.m. EDT",10382,9860,9117,-1265
ISNE,"4/28/2022 5 a.m. EDT",10706,10210,9582,-1124
ISNE,"4/28/2022 6 a.m. EDT",11094,11070,9867,-1227
ISNE,"4/28/2022 7 a.m. EDT",12251,12270,10909,-1342
ISNE,"4/28/2022 8 a.m. EDT",12592,12590,10854,-1738
ISNE,"4/28/2022 9 a.m. EDT",12106,12090,10551,-1555
ISNE,"4/28/2022 10 a.m. EDT",11484,11490,10219,-1265
ISNE,"4/28/2022 11 a.m. EDT",11048,10700,9658,-1390
ISNE,"4/28/2022 12 p.m. EDT",10766,10400,9644,-1122
ISNE,"4/28/2022 1 p.m. EDT",10636,10330,9667,-969
ISNE,"4/28/2022 2 p.m. EDT",10585,10120,9393,-1192
ISNE,"4/28/2022 3 p.m. EDT",10922,10220,9782,-1140
ISNE,"4/28/2022 4 p.m. EDT",10810,10400,9653,-1157
ISNE,"4/28/2022 5 p.m. EDT",10871,10910,9664,-1207
ISNE,"4/28/2022 6 p.m. EDT",11676,12120,10439,-1237
ISNE,"4/28/2022 7 p.m. EDT",12662,13080,11363,-1299
ISNE,"4/28/2022 8 p.m. EDT",13267,13500,11927,-1340
ISNE,"4/28/2022 9 p.m. EDT",13473,13430,12122,-1351
ISNE,"4/28/2022 10 p.m. EDT",12828,12670,11181,-1647
ISNE,"4/28/2022 11 p.m. EDT",11813,11690,10107,-1706
ISNE,"4/29/2022 12 a.m. EDT",10896,10820,9215,-1681
ISNE,"4/29/2022 1 a.m. EDT",10309,10300,8739,-1570
ISNE,"4/29/2022 2 a.m. EDT",10527,9980,8821,-1706
ISNE,"4/29/2022 3 a.m. EDT",10445,9860,8611,-1834
ISNE,"4/29/2022 4 a.m. EDT",10488,9920,9151,-1337
ISNE,"4/29/2022 5 a.m. EDT",10572,10270,9222,-1350
ISNE,"4/29/2022 6 a.m. EDT",11045,11070,9564,-1481
ISNE,"4/29/2022 7 a.m. EDT",12151,12160,10710,-1441
ISNE,"4/29/2022 8 a.m. EDT",12294,12270,10899,-1395
ISNE,"4/29/2022 9 a.m. EDT",11472,11460,10243,-1229
ISNE,"4/29/2022 10 a.m. EDT",10668,10530,9253,-1415
ISNE,"4/29/2022 11 a.m. EDT",10466,10120,9321,-1145
ISNE,"4/29/2022 12 p.m. EDT",10197,9670,9309,-888
ISNE,"4/29/2022 1 p.m. EDT",10002,9550,9123,-879
ISNE,"4/29/2022 2 p.m. EDT",10255,9490,9114,-1141
ISNE,"4/29/2022 3 p.m. EDT",10246,9510,9080,-1166
ISNE,"4/29/2022 4 p.m. EDT",10483,9800,9262,-1221
ISNE,"4/29/2022 5 p.m. EDT",11007,10650,10061,-946
ISNE,"4/29/2022 6 p.m. EDT",11525,11670,10421,-1104
ISNE,"4/29/2022 7 p.m. EDT",12256,12370,10873,-1383
ISNE,"4/29/2022 8 p.m. EDT",12695,12760,11354,-1341
ISNE,"4/29/2022 9 p.m. EDT",12853,12790,11431,-1422
ISNE,"4/29/2022 10 p.m. EDT",12336,12200,10884,-1452
ISNE,"4/29/2022 11 p.m. EDT",11498,11380,9830,-1668
ISNE,"4/30/2022 12 a.m. EDT",10682,10660,9179,-1503
ISNE,"4/30/2022 1 a.m. EDT",10123,10110,8724,-1399
ISNE,"4/30/2022 2 a.m. EDT",9772,9770,8687,-1085
ISNE,"4/30/2022 3 a.m. EDT",9611,9620,8258,-1353
ISNE,"4/30/2022 4 a.m. EDT",9561,9570,8356,-1205
ISNE,"4/30/2022 5 a.m. EDT",9719,9730,8359,-1360
ISNE,"4/30/2022 6 a.m. EDT",10063,10070,8832,-1231
ISNE,"4/30/2022 7 a.m. EDT",10450,10460,9058,-1392
ISNE,"4/30/2022 8 a.m. EDT",10481,10470,9214,-1267
ISNE,"4/30/2022 9 a.m. EDT",10149,10120,8981,-1168
ISNE,"4/30/2022 10 a.m. EDT",9423,9390,8434,-989
ISNE,"4/30/2022 11 a.m. EDT",8680,8660,7825,-855
ISNE,"4/30/2022 12 p.m. EDT",8784,8470,7987,-797
ISNE,"4/30/2022 1 p.m. EDT",8855,8220,8161,-694
ISNE,"4/30/2022 2 p.m. EDT",8983,8100,8185,-798
ISNE,"4/30/2022 3 p.m. EDT",8938,8120,8175,-763
ISNE,"4/30/2022 4 p.m. EDT",9062,8340,8118,-944
ISNE,"4/30/2022 5 p.m. EDT",9495,9280,8514,-981
ISNE,"4/30/2022 6 p.m. EDT",10270,10460,9360,-910
ISNE,"4/30/2022 7 p.m. EDT",11233,11410,10073,-1160
ISNE,"4/30/2022 8 p.m. EDT",11743,11910,10491,-1252
ISNE,"4/30/2022 9 p.m. EDT",12000,12020,10662,-1338
ISNE,"4/30/2022 10 p.m. EDT",11545,11490,10194,-1351
ISNE,"4/30/2022 11 p.m. EDT",10852,10780,9463,-1389
ISNE,"5/1/2022 12 a.m. EDT",10150,10090,8685,-1465
