"BA Code","Timestamp (Hour Ending)","Demand (MWh)","Demand Forecast (MWh)","Net Generation (MWh)","Total Interchange (MWh)"
ISNE,"5/1/2022 12 a.m. EDT",10150,10090,8685,-1465
ISNE,"5/1/2022 1 a.m. EDT",9624,9610,7828,-1796
ISNE,"5/1/2022 2 a.m. EDT",9303,9300,7445,-1858
ISNE,"5/1/2022 3 a.m. EDT",9144,9140,7313,-1831
ISNE,"5/1/2022 4 a.m. EDT",9110,9110,7263,-1847
ISNE,"5/1/2022 5 a.m. EDT",9204,9210,7287,-1917
ISNE,"5/1/2022 6 a.m. EDT",9447,9450,7510,-1937
ISNE,"5/1/2022 7 a.m. EDT",9643,9640,7611,-2032
ISNE,"5/1/2022 8 a.m. EDT",9456,9450,7776,-1680
ISNE,"5/1/2022 9 a.m. EDT",8939,8920,7437,-1502
ISNE,"5/1/2022 10 a.m. EDT",8396,8360,7181,-1215
ISNE,"5/1/2022 11 a.m. EDT",8393,7630,7275,-1118
ISNE,"5/1/2022 12 p.m. EDT",8355,7340,7309,-1046
ISNE,"5/1/2022 1 p.m. EDT",8240,7230,7261,-979
ISNE,"5/1/2022 2 p.m. EDT",8156,7310,7029,-1127
ISNE,"5/1/2022 3 p.m. EDT",8272,7470,7120,-1152
ISNE,"5/1/2022 4 p.m. EDT",8941,7980,7844,-1097
ISNE,"5/1/2022 5 p.m. EDT",9395,9080,8293,-1102
ISNE,"5/1/2022 6 p.m. EDT",10540,10520,9251,-1289
ISNE,"5/1/2022 7 p.m. EDT",11609,11510,9845,-1764
ISNE,"5/1/2022 8 p.m. EDT",12111,11970,10050,-2061
ISNE,"5/1/2022 9 p.m. EDT",12267,12130,10056,-2211
ISNE,"5/1/2022 10 p.m. EDT",11593,11540,9406,-2187
ISNE,"5/1/2022 11 p.m. EDT",10644,10630,8751,-1893
ISNE,"5/2/2022 12 a.m. EDT",9772,9850,8030,-1742
ISNE,"5/2/2022 1 a.m. EDT",9393,9220,7788,-1605
ISNE,"5/2/2022 2 a.m. EDT",9517,8930,7798,-1719
ISNE,"5/2/2022 3 a.m. EDT",9615,8840,7753,-1862
ISNE,"5/2/2022 4 a.m. EDT",9706,8850,7858,-1848
ISNE,"5/2/2022 5 a.m. EDT",9755,9180,7984,-1771
ISNE,"5/2/2022 6 a.m. EDT",10115,10050,8522,-1593
ISNE,"5/2/2022 7 a.m. EDT",11142,11220,9737,-1405
ISNE,"5/2/2022 8 a.m. EDT",11862,11940,10424,-1438
ISNE,"5/2/2022 9 a.m. EDT",12014,11920,10363,-1651
ISNE,"5/2/2022 10 a.m. EDT",12058,11980,10478,-1580
ISNE,"5/2/2022 11 a.m. EDT",12133,11890,10322,-1811
ISNE,"5/2/2022 12 p.m. EDT",12072,11980,10260,-1812
ISNE,"5/2/2022 1 p.m. EDT",12203,12010,10396,-1807
ISNE,"5/2/2022 2 p.m. EDT",12419,12160,10744,-1675
ISNE,"5/2/2022 3 p.m. EDT",12370,12170,10526,-1844
ISNE,"5/2/2022 4 p.m. EDT",12444,12400,10469,-1975
ISNE,"5/2/2022 5 p.m. EDT",12799,12690,10921,-1878
ISNE,"5/2/2022 6 p.m. EDT",13358,13190,11497,-1861
ISNE,"5/2/2022 7 p.m. EDT",13577,13330,11372,-2205
ISNE,"5/2/2022 8 p.m. EDT",13520,13350,11231,-2289
ISNE,"5/2/2022 9 p.m. EDT",13247,13110,11148,-2099
ISNE,"5/2/2022 10 p.m. EDT",12400,12310,10360,-2040
ISNE,"5/2/2022 11 p.m. EDT",11337,11210,9392,-1945
ISNE,"5/3/2022 12 a.m. EDT",10670,10240,8554,-2116
ISNE,"5/3/2022 1 a.m. EDT",10409,9640,8068,-2341
ISNE,"5/3/2022 2 a.m. EDT",10295,9310,7873,-2422
ISNE,"5/3/2022 3 a.m. EDT",10144,9140,7790,-2354
ISNE,"5/3/2022 4 a.m. EDT",10126,9300,7807,-2319
ISNE,"5/3/2022 5 a.m. EDT",10137,9570,7860,-2277
ISNE,"5/3/2022 6 a.m. EDT",10680,10330,8570,-2110
ISNE,"5/3/2022 7 a.m. EDT",11630,11550,9848,-1782
ISNE,"5/3/2022 8 a.m. EDT",12521,12440,10683,-1838
ISNE,"5/3/2022 9 a.m. EDT",12707,12650,10636,-2071
ISNE,"5/3/2022 10 a.m. EDT",12582,12540,10234,-2348
ISNE,"5/3/2022 11 a.m. EDT",12319,12330,9939,-2380
ISNE,"5/3/2022 12 p.m. EDT",12214,12050,9888,-2326
ISNE,"5/3/2022 1 p.m. EDT",12054,11670,10074,-1980
ISNE,"5/3/2022 2 p.m. EDT",11994,11510,9972,-2022
ISNE,"5/3/2022 3 p.m. EDT",11588,11410,9702,-1886
ISNE,"5/3/2022 4 p.m. EDT",11437,11480,9790,-1647
ISNE,"5/3/2022 5 p.m. EDT",11754,11950,10173,-1581
ISNE,"5/3/2022 6 p.m. EDT",12493,12680,10639,-1854
ISNE,"5/3/2022 7 p.m. EDT",12955,13140,10834,-2121
ISNE,"5/3/2022 8 p.m. EDT",13224,13310,11047,-2177
ISNE,"5/3/2022 9 p.m. EDT",13217,13500,11177,-2040
ISNE,"5/3/2022 10 p.m. EDT",12420,12400,10501,-1919
ISNE,"5/3/2022 11 p.m. EDT",11369,11310,9411,-1958
ISNE,"5/4/2022 12 a.m. EDT",10829,10360,8800,-2029
ISNE,"5/4/2022 1 a.m. EDT",10355,9740,8317,-2038
ISNE,"5/4/2022 2 a.m. EDT",10425,9360,8240,-2185
ISNE,"5/4/2022 3 a.m. EDT",10326,9160,8112,-2214
ISNE,"5/4/2022 4 a.m. EDT",10286,9150,8089,-2197
ISNE,"5/4/2022 5 a.m. EDT",10528,9440,8456,-2072
ISNE,"5/4/2022 6 a.m. EDT",10908,10250,8708,-2200
ISNE,"5/4/2022 7 a.m. EDT",11604,11490,9692,-1912
ISNE,"5/4/2022 8 a.m. EDT",12481,12810,10796,-1685
ISNE,"5/4/2022 9 a.m. EDT",12946,13170,11296,-1650
ISNE,"5/4/2022 10 a.m. EDT",13287,13360,11549,-1738
ISNE,"5/4/2022 11 a.m. EDT",13412,13450,11275,-2137
ISNE,"5/4/2022 12 p.m. EDT",13421,13470,11021,-2400
ISNE,"5/4/2022 1 p.m. EDT",13209,13390,10928,-2281
ISNE,"5/4/2022 2 p.m. EDT",12975,13360,10648,-2327
ISNE,"5/4/2022 3 p.m. EDT",12784,13260,10599,-2185
ISNE,"5/4/2022 4 p.m. EDT",12823,13200,10960,-1863
ISNE,"5/4/2022 5 p.m. EDT",13045,13230,11181,-1864
ISNE,"5/4/2022 6 p.m. EDT",13409,13640,11540,-1869
ISNE,"5/4/2022 7 p.m. EDT",13508,13750,11456,-2052
ISNE,"5/4/2022 8 p.m. EDT",13467,13640,11300,-2167
ISNE,"5/4/2022 9 p.m. EDT",13310,13230,11129,-2181
ISNE,"5/4/2022 10 p.m. EDT",12506,12330,10427,-2079
ISNE,"5/4/2022 11 p.m. EDT",11446,11270,9292,-2154
ISNE,"5/5/2022 12 a.m. EDT",10742,10370,8661,-2081
ISNE,"5/5/2022 1 a.m. EDT",10169,9840,7951,-2218
ISNE,"5/5/2022 2 a.m. EDT",9803,9480,7542,-2261
ISNE,"5/5/2022 3 a.m. EDT",9825,9300,7716,-2109
ISNE,"5/5/2022 4 a.m. EDT",9840,9290,7503,-2337
ISNE,"5/5/2022 5 a.m. EDT",9855,9580,7550,-2305
ISNE,"5/5/2022 6 a.m. EDT",10350,10360,7988,-2362
ISNE,"5/5/2022 7 a.m. EDT",11420,11430,8954,-2466
ISNE,"5/5/2022 8 a.m. EDT",11635,11620,9071,-2564
ISNE,"5/5/2022 9 a.m. EDT",10896,10890,8628,-2268
ISNE,"5/5/2022 10 a.m. EDT",10344,10100,8492,-1852
ISNE,"5/5/2022 11 a.m. EDT",10029,9620,8489,-1540
ISNE,"5/5/2022 12 p.m. EDT",9886,9360,8324,-1562
ISNE,"5/5/2022 1 p.m. EDT",9731,9280,8291,-1440
ISNE,"5/5/2022 2 p.m. EDT",9792,9350,8348,-1444
ISNE,"5/5/2022 3 p.m. EDT",9964,9450,8430,-1534
ISNE,"5/5/2022 4 p.m. EDT",10423,9890,8824,-1599
ISNE,"5/5/2022 5 p.m. EDT",10941,10810,9290,-1651
ISNE,"5/5/2022 6 p.m. EDT",11661,11930,10109,-1552
ISNE,"5/5/2022 7 p.m. EDT",12345,12670,10461,-1884
ISNE,"5/5/2022 8 p.m. EDT",12766,13020,10911,-1855
ISNE,"5/5/2022 9 p.m. EDT",12938,13080,11059,-1879
ISNE,"5/5/2022 10 p.m. EDT",12242,12320,10184,-2058
ISNE,"5/5/2022 11 p.m. EDT",11208,11270,9189,-2019
ISNE,"5/6/2022 12 a.m. EDT",10248,10260,8193,-2055
ISNE,"5/6/2022 1 a.m. EDT",9605,9610,7672,-1933
ISNE,"5/6/2022 2 a.m. EDT",9222,9220,7409,-1813
ISNE,"5/6/2022 3 a.m. EDT",9022,9040,7237,-1785
ISNE,"5/6/2022 4 a.m. EDT",8991,9010,7240,-1751
ISNE,"5/6/2022 5 a.m. EDT",9247,9270,7506,-1741
ISNE,"5/6/2022 6 a.m. EDT",9968,9990,7941,-2027
ISNE,"5/6/2022 7 a.m. EDT",11055,11090,9171,-1884
ISNE,"5/6/2022 8 a.m. EDT",11660,11640,9910,-1750
ISNE,"5/6/2022 9 a.m. EDT",11663,11680,10108,-1555
ISNE,"5/6/2022 10 a.m. EDT",11259,11270,9867,-1392
ISNE,"5/6/2022 11 a.m. EDT",10821,11220,9635,-1186
ISNE,"5/6/2022 12 p.m. EDT",11080,11140,9989,-1091
ISNE,"5/6/2022 1 p.m. EDT",11044,11100,9854,-1190
ISNE,"5/6/2022 2 p.m. EDT",11136,11210,9965,-1171
ISNE,"5/6/2022 3 p.m. EDT",11479,11270,10103,-1376
ISNE,"5/6/2022 4 p.m. EDT",11547,11490,10116,-1431
ISNE,"5/6/2022 5 p.m. EDT",11832,11810,10381,-1451
ISNE,"5/6/2022 6 p.m. EDT",12222,12260,10522,-1700
ISNE,"5/6/2022 7 p.m. EDT",12376,12620,10698,-1678
ISNE,"5/6/2022 8 p.m. EDT",12510,12730,10892,-1618
ISNE,"5/6/2022 9 p.m. EDT",12519,12690,11058,-1461
ISNE,"5/6/2022 10 p.m. EDT",11937,12050,10522,-1415
ISNE,"5/6/2022 11 p.m. EDT",11101,11180,9376,-1725
ISNE,"5/7/2022 12 a.m. EDT",10236,10320,8463,-1773
ISNE,"5/7/2022 1 a.m. EDT",9607,9600,8011,-1596
ISNE,"5/7/2022 2 a.m. EDT",9238,9220,7949,-1289
ISNE,"5/7/2022 3 a.m. EDT",9265,9010,7925,-1340
ISNE,"5/7/2022 4 a.m. EDT",9183,8930,7908,-1275
ISNE,"5/7/2022 5 a.m. EDT",9285,9030,7999,-1286
ISNE,"5/7/2022 6 a.m. EDT",9594,9340,8315,-1279
ISNE,"5/7/2022 7 a.m. EDT",9792,9790,8416,-1376
ISNE,"5/7/2022 8 a.m. EDT",10257,10260,8863,-1394
ISNE,"5/7/2022 9 a.m. EDT",10546,10540,9260,-1286
ISNE,"5/7/2022 10 a.m. EDT",10578,10500,9412,-1166
ISNE,"5/7/2022 11 a.m. EDT",10805,10450,9773,-1032
ISNE,"5/7/2022 12 p.m. EDT",10846,10400,9936,-910
ISNE,"5/7/2022 1 p.m. EDT",10514,10260,9584,-930
ISNE,"5/7/2022 2 p.m. EDT",10247,10110,9318,-929
ISNE,"5/7/2022 3 p.m. EDT",10249,10080,9258,-991
ISNE,"5/7/2022 4 p.m. EDT",10437,10160,9473,-964
ISNE,"5/7/2022 5 p.m. EDT",10853,10560,9884,-969
ISNE,"5/7/2022 6 p.m. EDT",11338,11370,10406,-932
ISNE,"5/7/2022 7 p.m. EDT",11872,12030,10493,-1379
ISNE,"5/7/2022 8 p.m. EDT",12195,12390,10793,-1402
ISNE,"5/7/2022 9 p.m. EDT",12338,12340,10872,-1466
ISNE,"5/7/2022 10 p.m. EDT",11860,11760,10360,-1500
ISNE,"5/7/2022 11 p.m. EDT",11124,10970,9554,-1570
ISNE,"5/8/2022 12 a.m. EDT",10365,10260,8705,-1660
ISNE,"5/8/2022 1 a.m. EDT",9796,9790,7589,-2207
ISNE,"5/8/2022 2 a.m. EDT",9418,9410,6874,-2544
ISNE,"5/8/2022 3 a.m. EDT",9205,9200,6556,-2649
ISNE,"5/8/2022 4 a.m. EDT",9129,9140,6588,-2541
ISNE,"5/8/2022 5 a.m. EDT",9205,9210,6673,-2532
ISNE,"5/8/2022 6 a.m. EDT",9392,9390,7001,-2391
ISNE,"5/8/2022 7 a.m. EDT",9547,9550,7258,-2289
ISNE,"5/8/2022 8 a.m. EDT",9797,9620,7630,-2167
ISNE,"5/8/2022 9 a.m. EDT",9652,9380,7652,-2000
ISNE,"5/8/2022 10 a.m. EDT",9237,8970,7751,-1486
ISNE,"5/8/2022 11 a.m. EDT",8966,8740,7894,-1072
ISNE,"5/8/2022 12 p.m. EDT",8926,8530,7774,-1152
ISNE,"5/8/2022 1 p.m. EDT",8942,8380,7822,-1120
ISNE,"5/8/2022 2 p.m. EDT",8710,8350,7376,-1334
ISNE,"5/8/2022 3 p.m. EDT",8798,8480,7366,-1432
ISNE,"5/8/2022 4 p.m. EDT",9154,8830,7769,-1385
ISNE,"5/8/2022 5 p.m. EDT",9903,9700,8496,-1407
ISNE,"5/8/2022 6 p.m. EDT",10442,10880,8861,-1581
ISNE,"5/8/2022 7 p.m. EDT",11371,11850,9542,-1829
ISNE,"5/8/2022 8 p.m. EDT",11989,12300,10044,-1945
ISNE,"5/8/2022 9 p.m. EDT",12328,12460,10274,-2054
ISNE,"5/8/2022 10 p.m. EDT",11836,11820,9828,-2008
ISNE,"5/8/2022 11 p.m. EDT",10950,10950,8779,-2171
ISNE,"5/9/2022 12 a.m. EDT",10122,10190,7874,-2248
ISNE,"5/9/2022 1 a.m. EDT",9601,9600,7286,-2315
ISNE,"5/9/2022 2 a.m. EDT",9332,9340,7062,-2270
ISNE,"5/9/2022 3 a.m. EDT",9232,9240,7047,-2185
ISNE,"5/9/2022 4 a.m. EDT",9289,9310,7067,-2222
ISNE,"5/9/2022 5 a.m. EDT",9661,9620,7186,-2475
ISNE,"5/9/2022 6 a.m. EDT",10515,10360,7961,-2554
ISNE,"5/9/2022 7 a.m. EDT",11626,11580,9182,-2444
ISNE,"5/9/2022 8 a.m. EDT",11796,11690,9273,-2523
ISNE,"5/9/2022 9 a.m. EDT",10975,10820,9101,-1874
ISNE,"5/9/2022 10 a.m. EDT",10489,9930,9166,-1323
ISNE,"5/9/2022 11 a.m. EDT",10352,9280,9232,-1120
ISNE,"5/9/2022 12 p.m. EDT",10066,9460,9100,-966
ISNE,"5/9/2022 1 p.m. EDT",10159,9400,9005,-1154
ISNE,"5/9/2022 2 p.m. EDT",10036,9300,8646,-1390
ISNE,"5/9/2022 3 p.m. EDT",9907,9190,8583,-1324
ISNE,"5/9/2022 4 p.m. EDT",10106,9550,8971,-1135
ISNE,"5/9/2022 5 p.m. EDT",10479,10350,9313,-1166
ISNE,"5/9/2022 6 p.m. EDT",11351,11290,10148,-1203
ISNE,"5/9/2022 7 p.m. EDT",12417,12410,10905,-1512
ISNE,"5/9/2022 8 p.m. EDT",12891,12900,10686,-2205
ISNE,"5/9/2022 9 p.m. EDT",13058,13060,10714,-2344
ISNE,"5/9/2022 10 p.m. EDT",12342,12330,10045,-2297
ISNE,"5/9/2022 11 p.m. EDT",11279,11300,8913,-2366
ISNE,"5/10/2022 12 a.m. EDT",10362,10340,8111,-2251
ISNE,"5/10/2022 1 a.m. EDT",9949,9750,7700,-2249
ISNE,"5/10/2022 2 a.m. EDT",9376,9340,7334,-2042
ISNE,"5/10/2022 3 a.m. EDT",9403,9180,7216,-2187
ISNE,"5/10/2022 4 a.m. EDT",9508,9180,7324,-2184
ISNE,"5/10/2022 5 a.m. EDT",9570,9500,7501,-2069
ISNE,"5/10/2022 6 a.m. EDT",10331,10280,8380,-1951
ISNE,"5/10/2022 7 a.m. EDT",11412,11390,9641,-1771
ISNE,"5/10/2022 8 a.m. EDT",11539,11330,9901,-1638
ISNE,"5/10/2022 9 a.m. EDT",10751,10360,9359,-1392
ISNE,"5/10/2022 10 a.m. EDT",10135,9620,8963,-1172
ISNE,"5/10/2022 11 a.m. EDT",10013,9520,8813,-1200
ISNE,"5/10/2022 12 p.m. EDT",9926,9250,8795,-1131
ISNE,"5/10/2022 1 p.m. EDT",10150,9190,8849,-1301
ISNE,"5/10/2022 2 p.m. EDT",10080,9250,8774,-1306
ISNE,"5/10/2022 3 p.m. EDT",9937,9330,8878,-1059
ISNE,"5/10/2022 4 p.m. EDT",9922,9750,8994,-928
ISNE,"5/10/2022 5 p.m. EDT",10428,10720,9362,-1066
ISNE,"5/10/2022 6 p.m. EDT",11345,11770,9970,-1375
ISNE,"5/10/2022 7 p.m. EDT",12365,12440,10812,-1553
ISNE,"5/10/2022 8 p.m. EDT",12815,12980,11461,-1354
ISNE,"5/10/2022 9 p.m. EDT",12944,13090,11576,-1368
ISNE,"5/10/2022 10 p.m. EDT",12303,12330,10964,-1339
ISNE,"5/10/2022 11 p.m. EDT",11208,11250,9611,-1597
ISNE,"5/11/2022 12 a.m. EDT",10242,10240,8533,-1709
ISNE,"5/11/2022 1 a.m. EDT",9637,9630,7991,-1646
ISNE,"5/11/2022 2 a.m. EDT",9300,9300,7681,-1619
ISNE,"5/11/2022 3 a.m. EDT",9403,9140,7723,-1680
ISNE,"5/11/2022 4 a.m. EDT",9395,9160,7687,-1708
ISNE,"5/11/2022 5 a.m. EDT",9467,9460,7968,-1499
ISNE,"5/11/2022 6 a.m. EDT",10184,10170,8688,-1496
ISNE,"5/11/2022 7 a.m. EDT",11306,11270,9998,-1308
ISNE,"5/11/2022 8 a.m. EDT",11702,11590,10601,-1101
ISNE,"5/11/2022 9 a.m. EDT",11214,11160,10036,-1178
ISNE,"5/11/2022 10 a.m. EDT",10642,10600,9376,-1266
ISNE,"5/11/2022 11 a.m. EDT",10527,10280,9476,-1051
ISNE,"5/11/2022 12 p.m. EDT",10285,9750,9165,-1120
ISNE,"5/11/2022 1 p.m. EDT",9855,9810,8729,-1126
ISNE,"5/11/2022 2 p.m. EDT",10193,10150,8981,-1212
ISNE,"5/11/2022 3 p.m. EDT",10315,10430,9180,-1135
ISNE,"5/11/2022 4 p.m. EDT",10628,10730,9620,-1008
ISNE,"5/11/2022 5 p.m. EDT",11156,11200,10101,-1055
ISNE,"5/11/2022 6 p.m. EDT",12052,12110,10815,-1237
ISNE,"5/11/2022 7 p.m. EDT",12767,12680,11316,-1451
ISNE,"5/11/2022 8 p.m. EDT",13055,12890,11614,-1441
ISNE,"5/11/2022 9 p.m. EDT",13141,13000,11589,-1552
ISNE,"5/11/2022 10 p.m. EDT",12472,12240,11037,-1435
ISNE,"5/11/2022 11 p.m. EDT",11406,11180,9902,-1504
ISNE,"5/12/2022 12 a.m. EDT",10364,10220,8719,-1645
ISNE,"5/12/2022 1 a.m. EDT",9683,9680,7755,-1928
ISNE,"5/12/2022 2 a.m. EDT",9280,9280,7383,-1897
ISNE,"5/12/2022 3 a.m. EDT",9060,9080,7108,-1952
ISNE,"5/12/2022 4 a.m. EDT",9256,9050,7294,-1962
ISNE,"5/12/2022 5 a.m. EDT",9358,9290,7422,-1936
ISNE,"5/12/2022 6 a.m. EDT",9952,9970,8170,-1782
ISNE,"5/12/2022 7 a.m. EDT",11070,11090,9338,-1732
ISNE,"5/12/2022 8 a.m. EDT",11672,11680,10151,-1521
ISNE,"5/12/2022 9 a.m. EDT",11524,11510,10198,-1326
ISNE,"5/12/2022 10 a.m. EDT",11151,11120,9964,-1187
ISNE,"5/12/2022 11 a.m. EDT",10712,10740,9583,-1129
ISNE,"5/12/2022 12 p.m. EDT",10660,10450,9587,-1073
ISNE,"5/12/2022 1 p.m. EDT",10602,10410,9566,-1036
ISNE,"5/12/2022 2 p.m. EDT",10754,10520,9680,-1074
ISNE,"5/12/2022 3 p.m. EDT",10979,10630,9909,-1070
ISNE,"5/12/2022 4 p.m. EDT",11296,11090,10228,-1068
ISNE,"5/12/2022 5 p.m. EDT",11999,11830,10683,-1316
ISNE,"5/12/2022 6 p.m. EDT",12867,12790,11144,-1723
ISNE,"5/12/2022 7 p.m. EDT",13535,13510,11628,-1907
ISNE,"5/12/2022 8 p.m. EDT",13744,13730,11807,-1937
ISNE,"5/12/2022 9 p.m. EDT",13820,13750,11849,-1971
ISNE,"5/12/2022 10 p.m. EDT",13123,12920,11184,-1939
ISNE,"5/12/2022 11 p.m. EDT",11999,11790,10196,-1803
ISNE,"5/13/2022 12 a.m. EDT",10898,10720,9137,-1761
ISNE,"5/13/2022 1 a.m. EDT",10149,10130,8153,-1996
ISNE,"5/13/2022 2 a.m. EDT",9690,9680,7496,-2194
ISNE,"5/13/2022 3 a.m. EDT",9705,9430,7481,-2224
ISNE,"5/13/2022 4 a.m. EDT",9694,9370,7608,-2086
ISNE,"5/13/2022 5 a.m. EDT",9894,9580,7773,-2121
ISNE,"5/13/2022 6 a.m. EDT",10231,10190,8271,-1960
ISNE,"5/13/2022 7 a.m. EDT",11234,11260,9448,-1786
ISNE,"5/13/2022 8 a.m. EDT",12014,12020,10405,-1609
ISNE,"5/13/2022 9 a.m. EDT",12188,12180,10640,-1548
ISNE,"5/13/2022 10 a.m. EDT",11940,11960,10480,-1460
ISNE,"5/13/2022 11 a.m. EDT",11773,11840,10423,-1350
ISNE,"5/13/2022 12 p.m. EDT",11651,11690,10231,-1420
ISNE,"5/13/2022 1 p.m. EDT",12024,11680,10667,-1357
ISNE,"5/13/2022 2 p.m. EDT",12008,11820,10802,-1206
ISNE,"5/13/2022 3 p.m. EDT",12042,12000,11014,-1028
ISNE,"5/13/2022 4 p.m. EDT",12371,12360,11200,-1171
ISNE,"5/13/2022 5 p.m. EDT",13250,12980,11784,-1466
ISNE,"5/13/2022 6 p.m. EDT",14129,13600,12568,-1561
ISNE,"5/13/2022 7 p.m. EDT",14611,14010,13066,-1545
ISNE,"5/13/2022 8 p.m. EDT",14666,14080,12838,-1828
ISNE,"5/13/2022 9 p.m. EDT",14580,14250,12576,-2004
ISNE,"5/13/2022 10 p.m. EDT",13985,13280,11771,-2214
ISNE,"5/13/2022 11 p.m. EDT",12957,12300,10732,-2225
ISNE,"5/14/2022 12 a.m. EDT",11910,11340,9930,-1980
ISNE,"5/14/2022 1 a.m. EDT",11387,11060,9674,-1713
ISNE,"5/14/2022 2 a.m. EDT",10845,10510,8924,-1921
ISNE,"5/14/2022 3 a.m. EDT",10690,10120,8599,-2091
ISNE,"5/14/2022 4 a.m. EDT",10502,9930,8629,-1873
ISNE,"5/14/2022 5 a.m. EDT",10518,9950,8750,-1768
ISNE,"5/14/2022 6 a.m. EDT",10581,10080,8992,-1589
ISNE,"5/14/2022 7 a.m. EDT",10697,10390,9417,-1280
ISNE,"5/14/2022 8 a.m. EDT",10722,10740,9682,-1040
ISNE,"5/14/2022 9 a.m. EDT",10907,10910,10040,-867
ISNE,"5/14/2022 10 a.m. EDT",11020,11130,10373,-647
ISNE,"5/14/2022 11 a.m. EDT",11203,11390,10533,-670
ISNE,"5/14/2022 12 p.m. EDT",11532,11670,10945,-587
ISNE,"5/14/2022 1 p.m. EDT",11881,12050,11184,-697
ISNE,"5/14/2022 2 p.m. EDT",12343,12400,11343,-1000
ISNE,"5/14/2022 3 p.m. EDT",12926,12610,11892,-1034
ISNE,"5/14/2022 4 p.m. EDT",13560,13180,12402,-1158
ISNE,"5/14/2022 5 p.m. EDT",14309,13930,13061,-1248
ISNE,"5/14/2022 6 p.m. EDT",14770,14780,13269,-1501
ISNE,"5/14/2022 7 p.m. EDT",14830,15270,13371,-1459
ISNE,"5/14/2022 8 p.m. EDT",14782,15750,13663,-1119
ISNE,"5/14/2022 9 p.m. EDT",14751,15280,13748,-1003
ISNE,"5/14/2022 10 p.m. EDT",14156,14300,13137,-1019
ISNE,"5/14/2022 11 p.m. EDT",13183,13310,12146,-1037
ISNE,"5/15/2022 12 a.m. EDT",12160,12350,10898,-1262
ISNE,"5/15/2022 1 a.m. EDT",11385,11340,9894,-1491
ISNE,"5/15/2022 2 a.m. EDT",11125,10800,9577,-1548
ISNE,"5/15/2022 3 a.m. EDT",10738,10420,9220,-1518
ISNE,"5/15/2022 4 a.m. EDT",10481,10170,8926,-1555
ISNE,"5/15/2022 5 a.m. EDT",10375,10070,8843,-1532
ISNE,"5/15/2022 6 a.m. EDT",10427,10110,8868,-1559
ISNE,"5/15/2022 7 a.m. EDT",10538,10250,8908,-1630
ISNE,"5/15/2022 8 a.m. EDT",10516,10530,8925,-1591
ISNE,"5/15/2022 9 a.m. EDT",10941,10960,9886,-1055
ISNE,"5/15/2022 10 a.m. EDT",11243,11300,10410,-833
ISNE,"5/15/2022 11 a.m. EDT",11450,11440,10504,-946
ISNE,"5/15/2022 12 p.m. EDT",11622,11560,10710,-912
ISNE,"5/15/2022 1 p.m. EDT",11797,11730,11021,-776
ISNE,"5/15/2022 2 p.m. EDT",11913,11940,11214,-699
ISNE,"5/15/2022 3 p.m. EDT",12119,12020,11427,-692
ISNE,"5/15/2022 4 p.m. EDT",12623,12390,11914,-709
ISNE,"5/15/2022 5 p.m. EDT",13428,13210,12561,-867
ISNE,"5/15/2022 6 p.m. EDT",14411,13940,13344,-1067
ISNE,"5/15/2022 7 p.m. EDT",14953,15110,13637,-1316
ISNE,"5/15/2022 8 p.m. EDT",14922,15490,13586,-1336
ISNE,"5/15/2022 9 p.m. EDT",14746,15500,13536,-1210
ISNE,"5/15/2022 10 p.m. EDT",13936,14310,12640,-1296
ISNE,"5/15/2022 11 p.m. EDT",12750,12810,11153,-1597
ISNE,"5/16/2022 12 a.m. EDT",11598,11400,9872,-1726
ISNE,"5/16/2022 1 a.m. EDT",11082,10790,9426,-1656
ISNE,"5/16/2022 2 a.m. EDT",10605,10310,9151,-1454
ISNE,"5/16/2022 3 a.m. EDT",10305,10060,8840,-1465
ISNE,"5/16/2022 4 a.m. EDT",10192,9990,9040,-1152
ISNE,"5/16/2022 5 a.m. EDT",10403,10200,9257,-1146
ISNE,"5/16/2022 6 a.m. EDT",11050,10940,9596,-1454
ISNE,"5/16/2022 7 a.m. EDT",11914,12150,10249,-1665
ISNE,"5/16/2022 8 a.m. EDT",12523,12780,11011,-1512
ISNE,"5/16/2022 9 a.m. EDT",12557,12720,11035,-1522
ISNE,"5/16/2022 10 a.m. EDT",12329,12470,11014,-1315
ISNE,"5/16/2022 11 a.m. EDT",12350,12150,11159,-1191
ISNE,"5/16/2022 12 p.m. EDT",12726,12400,11397,-1329
ISNE,"5/16/2022 1 p.m. EDT",13382,12930,12182,-1200
ISNE,"5/16/2022 2 p.m. EDT",13907,13440,12527,-1380
ISNE,"5/16/2022 3 p.m. EDT",14097,13760,12893,-1204
ISNE,"5/16/2022 4 p.m. EDT",14315,14200,12973,-1342
ISNE,"5/16/2022 5 p.m. EDT",15010,14680,13357,-1653
ISNE,"5/16/2022 6 p.m. EDT",15631,15360,13657,-1974
ISNE,"5/16/2022 7 p.m. EDT",15660,15630,13661,-1999
ISNE,"5/16/2022 8 p.m. EDT",15310,15750,13413,-1897
ISNE,"5/16/2022 9 p.m. EDT",14975,15160,13418,-1557
ISNE,"5/16/2022 10 p.m. EDT",14035,14180,12164,-1871
ISNE,"5/16/2022 11 p.m. EDT",12768,12860,10579,-2189
ISNE,"5/17/2022 12 a.m. EDT",11648,11690,9605,-2043
ISNE,"5/17/2022 1 a.m. EDT",11107,10560,9068,-2039
ISNE,"5/17/2022 2 a.m. EDT",10556,10070,8537,-2019
ISNE,"5/17/2022 3 a.m. EDT",10124,9740,8197,-1927
ISNE,"5/17/2022 4 a.m. EDT",9940,9630,8104,-1836
ISNE,"5/17/2022 5 a.m. EDT",10066,9810,8152,-1914
ISNE,"5/17/2022 6 a.m. EDT",10562,10380,8668,-1894
ISNE,"5/17/2022 7 a.m. EDT",11287,11450,9452,-1835
ISNE,"5/17/2022 8 a.m. EDT",11684,11780,9584,-2100
ISNE,"5/17/2022 9 a.m. EDT",11263,11240,9261,-2002
ISNE,"5/17/2022 10 a.m. EDT",10759,10480,8895,-1864
ISNE,"5/17/2022 11 a.m. EDT",10716,10430,9187,-1529
ISNE,"5/17/2022 12 p.m. EDT",11121,10570,9368,-1753
ISNE,"5/17/2022 1 p.m. EDT",11823,10770,10115,-1708
ISNE,"5/17/2022 2 p.m. EDT",11974,11960,10432,-1542
ISNE,"5/17/2022 3 p.m. EDT",11821,11920,10443,-1378
ISNE,"5/17/2022 4 p.m. EDT",11987,12040,10347,-1640
ISNE,"5/17/2022 5 p.m. EDT",12440,12360,10518,-1922
ISNE,"5/17/2022 6 p.m. EDT",13095,12910,11321,-1774
ISNE,"5/17/2022 7 p.m. EDT",13565,13470,11857,-1708
ISNE,"5/17/2022 8 p.m. EDT",13637,13750,11967,-1670
ISNE,"5/17/2022 9 p.m. EDT",13571,13490,11796,-1775
ISNE,"5/17/2022 10 p.m. EDT",12801,12710,11014,-1787
ISNE,"5/17/2022 11 p.m. EDT",11663,11530,9884,-1779
ISNE,"5/18/2022 12 a.m. EDT",10606,10530,9125,-1481
ISNE,"5/18/2022 1 a.m. EDT",9884,9860,8394,-1490
ISNE,"5/18/2022 2 a.m. EDT",9439,9440,7985,-1454
ISNE,"5/18/2022 3 a.m. EDT",9486,9190,8005,-1481
ISNE,"5/18/2022 4 a.m. EDT",9424,9120,7987,-1437
ISNE,"5/18/2022 5 a.m. EDT",9657,9320,8184,-1473
ISNE,"5/18/2022 6 a.m. EDT",10038,10020,8620,-1418
ISNE,"5/18/2022 7 a.m. EDT",10951,11240,9233,-1718
ISNE,"5/18/2022 8 a.m. EDT",11255,11480,9197,-2058
ISNE,"5/18/2022 9 a.m. EDT",10687,10590,8990,-1697
ISNE,"5/18/2022 10 a.m. EDT",10033,9660,8668,-1365
ISNE,"5/18/2022 11 a.m. EDT",9962,9150,8620,-1342
ISNE,"5/18/2022 12 p.m. EDT",9910,9120,8434,-1476
ISNE,"5/18/2022 1 p.m. EDT",9925,9650,8394,-1531
ISNE,"5/18/2022 2 p.m. EDT",9905,9800,8357,-1548
ISNE,"5/18/2022 3 p.m. EDT",10092,10020,8634,-1458
ISNE,"5/18/2022 4 p.m. EDT",10580,10350,9244,-1336
ISNE,"5/18/2022 5 p.m. EDT",11457,11040,10055,-1402
ISNE,"5/18/2022 6 p.m. EDT",12612,12030,11227,-1385
ISNE,"5/18/2022 7 p.m. EDT",13160,12650,11745,-1415
ISNE,"5/18/2022 8 p.m. EDT",13306,13110,11967,-1339
ISNE,"5/18/2022 9 p.m. EDT",13370,13200,11954,-1416
ISNE,"5/18/2022 10 p.m. EDT",12643,12400,11191,-1452
ISNE,"5/18/2022 11 p.m. EDT",11535,11330,9657,-1878
ISNE,"5/19/2022 12 a.m. EDT",10528,10370,8567,-1961
ISNE,"5/19/2022 1 a.m. EDT",10141,9830,7950,-2191
ISNE,"5/19/2022 2 a.m. EDT",9746,9410,7900,-1846
ISNE,"5/19/2022 3 a.m. EDT",9542,9210,7759,-1783
ISNE,"5/19/2022 4 a.m. EDT",9489,9170,7747,-1742
ISNE,"5/19/2022 5 a.m. EDT",9714,9450,7993,-1721
ISNE,"5/19/2022 6 a.m. EDT",10306,10120,8584,-1722
ISNE,"5/19/2022 7 a.m. EDT",11230,11230,9782,-1448
ISNE,"5/19/2022 8 a.m. EDT",12200,12130,10711,-1489
ISNE,"5/19/2022 9 a.m. EDT",12670,12510,11206,-1464
ISNE,"5/19/2022 10 a.m. EDT",12960,12820,11481,-1479
ISNE,"5/19/2022 11 a.m. EDT",13118,13010,11554,-1564
ISNE,"5/19/2022 12 p.m. EDT",13199,13080,11710,-1489
ISNE,"5/19/2022 1 p.m. EDT",13206,13090,11920,-1286
ISNE,"5/19/2022 2 p.m. EDT",13117,13090,11609,-1508
ISNE,"5/19/2022 3 p.m. EDT",12934,12900,11427,-1507
ISNE,"5/19/2022 4 p.m. EDT",12898,12760,11480,-1418
ISNE,"5/19/2022 5 p.m. EDT",13059,13030,11642,-1417
ISNE,"5/19/2022 6 p.m. EDT",13352,13100,11920,-1432
ISNE,"5/19/2022 7 p.m. EDT",13346,13190,12005,-1341
ISNE,"5/19/2022 8 p.m. EDT",13280,13240,11913,-1367
ISNE,"5/19/2022 9 p.m. EDT",13191,13300,11850,-1341
ISNE,"5/19/2022 10 p.m. EDT",12492,12560,10992,-1500
ISNE,"5/19/2022 11 p.m. EDT",11484,11460,9762,-1722
ISNE,"5/20/2022 12 a.m. EDT",10784,10470,8873,-1911
ISNE,"5/20/2022 1 a.m. EDT",10160,9820,8530,-1630
ISNE,"5/20/2022 2 a.m. EDT",9734,9410,8268,-1466
ISNE,"5/20/2022 3 a.m. EDT",9521,9210,7912,-1609
ISNE,"5/20/2022 4 a.m. EDT",9462,9150,7834,-1628
ISNE,"5/20/2022 5 a.m. EDT",9693,9380,8086,-1607
ISNE,"5/20/2022 6 a.m. EDT",10117,10020,8468,-1649
ISNE,"5/20/2022 7 a.m. EDT",11034,11060,9427,-1607
ISNE,"5/20/2022 8 a.m. EDT",11729,11690,10302,-1427
ISNE,"5/20/2022 9 a.m. EDT",11905,11680,10507,-1398
ISNE,"5/20/2022 10 a.m. EDT",11746,11950,10356,-1390
ISNE,"5/20/2022 11 a.m. EDT",11047,11150,9889,-1158
ISNE,"5/20/2022 12 p.m. EDT",10582,10850,9315,-1267
ISNE,"5/20/2022 1 p.m. EDT",10380,10800,9119,-1261
ISNE,"5/20/2022 2 p.m. EDT",10532,11070,9372,-1160
ISNE,"5/20/2022 3 p.m. EDT",10741,11490,9472,-1269
ISNE,"5/20/2022 4 p.m. EDT",11184,11830,9889,-1295
ISNE,"5/20/2022 5 p.m. EDT",11824,11900,10457,-1367
ISNE,"5/20/2022 6 p.m. EDT",12645,13000,11230,-1415
ISNE,"5/20/2022 7 p.m. EDT",13105,13930,11545,-1560
ISNE,"5/20/2022 8 p.m. EDT",13254,13650,11480,-1774
ISNE,"5/20/2022 9 p.m. EDT",13321,13780,11509,-1812
ISNE,"5/20/2022 10 p.m. EDT",12788,13140,10927,-1861
ISNE,"5/20/2022 11 p.m. EDT",12111,12160,10310,-1801
ISNE,"5/21/2022 12 a.m. EDT",11231,11140,9315,-1916
ISNE,"5/21/2022 1 a.m. EDT",11013,10360,8849,-2164
ISNE,"5/21/2022 2 a.m. EDT",10592,9870,8458,-2134
ISNE,"5/21/2022 3 a.m. EDT",10612,9630,8412,-2200
ISNE,"5/21/2022 4 a.m. EDT",10517,9470,8234,-2283
ISNE,"5/21/2022 5 a.m. EDT",10573,9500,8236,-2337
ISNE,"5/21/2022 6 a.m. EDT",10514,9660,8072,-2442
ISNE,"5/21/2022 7 a.m. EDT",10918,9990,8745,-2173
ISNE,"5/21/2022 8 a.m. EDT",11547,10710,9382,-2165
ISNE,"5/21/2022 9 a.m. EDT",11902,11240,9858,-2044
ISNE,"5/21/2022 10 a.m. EDT",12076,11400,10284,-1792
ISNE,"5/21/2022 11 a.m. EDT",11502,11590,9748,-1754
ISNE,"5/21/2022 12 p.m. EDT",10964,11080,9840,-1124
ISNE,"5/21/2022 1 p.m. EDT",10760,11430,10116,-644
ISNE,"5/21/2022 2 p.m. EDT",11276,11280,10727,-549
ISNE,"5/21/2022 3 p.m. EDT",12146,12180,11219,-927
ISNE,"5/21/2022 4 p.m. EDT",13268,13700,12361,-907
ISNE,"5/21/2022 5 p.m. EDT",14499,14610,13209,-1290
ISNE,"5/21/2022 6 p.m. EDT",15544,16150,14061,-1483
ISNE,"5/21/2022 7 p.m. EDT",16033,16490,14434,-1599
ISNE,"5/21/2022 8 p.m. EDT",15873,16740,14266,-1607
ISNE,"5/21/2022 9 p.m. EDT",15620,16270,14023,-1597
ISNE,"5/21/2022 10 p.m. EDT",14899,15650,13232,-1667
ISNE,"5/21/2022 11 p.m. EDT",13826,14430,11998,-1828
ISNE,"5/22/2022 12 a.m. EDT",12958,13270,11385,-1573
ISNE,"5/22/2022 1 a.m. EDT",12073,12510,10385,-1688
ISNE,"5/22/2022 2 a.m. EDT",11728,11850,10092,-1636
ISNE,"5/22/2022 3 a.m. EDT",11586,11370,10087,-1499
ISNE,"5/22/2022 4 a.m. EDT",11274,10420,9709,-1565
ISNE,"5/22/2022 5 a.m. EDT",11132,10270,9409,-1723
ISNE,"5/22/2022 6 a.m. EDT",11062,10310,9139,-1923
ISNE,"5/22/2022 7 a.m. EDT",11190,10540,9354,-1836
ISNE,"5/22/2022 8 a.m. EDT",11519,11070,9569,-1950
ISNE,"5/22/2022 9 a.m. EDT",11328,11770,9503,-1825
ISNE,"5/22/2022 10 a.m. EDT",11926,11700,10153,-1773
ISNE,"5/22/2022 11 a.m. EDT",12828,12720,11336,-1492
ISNE,"5/22/2022 12 p.m. EDT",13755,13450,12347,-1408
ISNE,"5/22/2022 1 p.m. EDT",14593,14360,13174,-1419
ISNE,"5/22/2022 2 p.m. EDT",14982,15050,13320,-1662
ISNE,"5/22/2022 3 p.m. EDT",15460,15710,13850,-1610
ISNE,"5/22/2022 4 p.m. EDT",16280,16530,14714,-1566
ISNE,"5/22/2022 5 p.m. EDT",17363,17440,15665,-1698
ISNE,"5/22/2022 6 p.m. EDT",18286,18330,16315,-1971
ISNE,"5/22/2022 7 p.m. EDT",18556,18450,16420,-2136
ISNE,"5/22/2022 8 p.m. EDT",18268,18100,15938,-2330
ISNE,"5/22/2022 9 p.m. EDT",17778,16960,15457,-2321
ISNE,"5/22/2022 10 p.m. EDT",16582,15910,14362,-2220
ISNE,"5/22/2022 11 p.m. EDT",14987,14370,12869,-2118
ISNE,"5/23/2022 12 a.m. EDT",13569,12850,11517,-2052
ISNE,"5/23/2022 1 a.m. EDT",12501,12470,10629,-1872
ISNE,"5/23/2022 2 a.m. EDT",11798,11740,9950,-1848
ISNE,"5/23/2022 3 a.m. EDT",11577,11240,9713,-1864
ISNE,"5/23/2022 4 a.m. EDT",11223,10900,9479,-1744
ISNE,"5/23/2022 5 a.m. EDT",11182,10870,9481,-1701
ISNE,"5/23/2022 6 a.m. EDT",11551,11250,9846,-1705
ISNE,"5/23/2022 7 a.m. EDT",11945,11980,10566,-1379
ISNE,"5/23/2022 8 a.m. EDT",12327,12340,11115,-1212
ISNE,"5/23/2022 9 a.m. EDT",12098,12110,10745,-1353
ISNE,"5/23/2022 10 a.m. EDT",11659,11860,10513,-1146
ISNE,"5/23/2022 11 a.m. EDT",11296,11450,10061,-1235
ISNE,"5/23/2022 12 p.m. EDT",11496,11140,10297,-1199
ISNE,"5/23/2022 1 p.m. EDT",11491,11280,10215,-1276
ISNE,"5/23/2022 2 p.m. EDT",11462,11740,10313,-1149
ISNE,"5/23/2022 3 p.m. EDT",11566,12150,10448,-1118
ISNE,"5/23/2022 4 p.m. EDT",12131,12560,10976,-1155
ISNE,"5/23/2022 5 p.m. EDT",13085,13100,11936,-1149
ISNE,"5/23/2022 6 p.m. EDT",13887,13840,12711,-1176
ISNE,"5/23/2022 7 p.m. EDT",14244,14300,12891,-1353
ISNE,"5/23/2022 8 p.m. EDT",14221,14220,12615,-1606
ISNE,"5/23/2022 9 p.m. EDT",14162,13890,12528,-1634
ISNE,"5/23/2022 10 p.m. EDT",13390,13330,11934,-1456
ISNE,"5/23/2022 11 p.m. EDT",12169,12120,10620,-1549
ISNE,"5/24/2022 12 a.m. EDT",11018,10950,9684,-1334
ISNE,"5/24/2022 1 a.m. EDT",10271,10280,9297,-974
ISNE,"5/24/2022 2 a.m. EDT",10065,9780,9075,-990
ISNE,"5/24/2022 3 a.m. EDT",9796,9500,8689,-1107
ISNE,"5/24/2022 4 a.m. EDT",9655,9390,8686,-969
ISNE,"5/24/2022 5 a.m. EDT",9540,9580,8738,-802
ISNE,"5/24/2022 6 a.m. EDT",10120,10170,9226,-894
ISNE,"5/24/2022 7 a.m. EDT",11030,11080,10068,-962
ISNE,"5/24/2022 8 a.m. EDT",11527,11560,10389,-1138
ISNE,"5/24/2022 9 a.m. EDT",11297,11320,10345,-952
ISNE,"5/24/2022 10 a.m. EDT",10696,10720,10094,-602
ISNE,"5/24/2022 11 a.m. EDT",10348,9940,9754,-594
ISNE,"5/24/2022 12 p.m. EDT",10130,9650,9520,-610
ISNE,"5/24/2022 1 p.m. EDT",10294,9790,9655,-639
ISNE,"5/24/2022 2 p.m. EDT",10463,10010,9770,-693
ISNE,"5/24/2022 3 p.m. EDT",10691,10380,9955,-736
ISNE,"5/24/2022 4 p.m. EDT",11203,10910,10436,-767
ISNE,"5/24/2022 5 p.m. EDT",11956,11630,10784,-1172
ISNE,"5/24/2022 6 p.m. EDT",12702,12660,11310,-1392
ISNE,"5/24/2022 7 p.m. EDT",13263,13260,11742,-1521
ISNE,"5/24/2022 8 p.m. EDT",13389,13460,11756,-1633
ISNE,"5/24/2022 9 p.m. EDT",13381,13400,11735,-1646
ISNE,"5/24/2022 10 p.m. EDT",12724,12680,11028,-1696
ISNE,"5/24/2022 11 p.m. EDT",11589,11560,9891,-1698
ISNE,"5/25/2022 12 a.m. EDT",10700,10500,8926,-1774
ISNE,"5/25/2022 1 a.m. EDT",10178,9860,8421,-1757
ISNE,"5/25/2022 2 a.m. EDT",9754,9450,8151,-1603
ISNE,"5/25/2022 3 a.m. EDT",9513,9210,7950,-1563
ISNE,"5/25/2022 4 a.m. EDT",9449,9170,7811,-1638
ISNE,"5/25/2022 5 a.m. EDT",9705,9430,8281,-1424
ISNE,"5/25/2022 6 a.m. EDT",10258,10000,9113,-1145
ISNE,"5/25/2022 7 a.m. EDT",10922,10980,9850,-1072
ISNE,"5/25/2022 8 a.m. EDT",11330,11360,10250,-1080
ISNE,"5/25/2022 9 a.m. EDT",10971,10980,9855,-1116
ISNE,"5/25/2022 10 a.m. EDT",10450,10450,9381,-1069
ISNE,"5/25/2022 11 a.m. EDT",10413,10060,9334,-1079
ISNE,"5/25/2022 12 p.m. EDT",10434,9800,9363,-1071
ISNE,"5/25/2022 1 p.m. EDT",10511,9760,9513,-998
ISNE,"5/25/2022 2 p.m. EDT",10798,9910,9799,-999
ISNE,"5/25/2022 3 p.m. EDT",10798,10400,9761,-1037
ISNE,"5/25/2022 4 p.m. EDT",11255,10940,10198,-1057
ISNE,"5/25/2022 5 p.m. EDT",12024,11710,10863,-1161
ISNE,"5/25/2022 6 p.m. EDT",12948,12650,11716,-1232
ISNE,"5/25/2022 7 p.m. EDT",13481,13160,11900,-1581
ISNE,"5/25/2022 8 p.m. EDT",13571,13330,11733,-1838
ISNE,"5/25/2022 9 p.m. EDT",13563,13390,11787,-1776
ISNE,"5/25/2022 10 p.m. EDT",12881,12670,11334,-1547
ISNE,"5/25/2022 11 p.m. EDT",11736,11560,10112,-1624
ISNE,"5/26/2022 12 a.m. EDT",10670,10510,8720,-1950
ISNE,"5/26/2022 1 a.m. EDT",10263,9880,8333,-1930
ISNE,"5/26/2022 2 a.m. EDT",9803,9440,8023,-1780
ISNE,"5/26/2022 3 a.m. EDT",9565,9220,7966,-1599
ISNE,"5/26/2022 4 a.m. EDT",9508,9160,7955,-1553
ISNE,"5/26/2022 5 a.m. EDT",9726,9340,8164,-1562
ISNE,"5/26/2022 6 a.m. EDT",10251,9970,8973,-1278
ISNE,"5/26/2022 7 a.m. EDT",10943,11030,9742,-1201
ISNE,"5/26/2022 8 a.m. EDT",11557,11480,10473,-1084
ISNE,"5/26/2022 9 a.m. EDT",11399,11210,10357,-1042
ISNE,"5/26/2022 10 a.m. EDT",10955,10810,9985,-970
ISNE,"5/26/2022 11 a.m. EDT",10812,10460,9875,-937
ISNE,"5/26/2022 12 p.m. EDT",10787,10330,9818,-969
ISNE,"5/26/2022 1 p.m. EDT",10712,10400,9764,-948
ISNE,"5/26/2022 2 p.m. EDT",10861,10690,9946,-915
ISNE,"5/26/2022 3 p.m. EDT",11067,10770,10078,-989
ISNE,"5/26/2022 4 p.m. EDT",11151,11220,10194,-957
ISNE,"5/26/2022 5 p.m. EDT",12042,11850,11083,-959
ISNE,"5/26/2022 6 p.m. EDT",12965,12670,11940,-1025
ISNE,"5/26/2022 7 p.m. EDT",13442,13230,12385,-1057
ISNE,"5/26/2022 8 p.m. EDT",13611,13410,12353,-1258
ISNE,"5/26/2022 9 p.m. EDT",13686,13450,12314,-1372
ISNE,"5/26/2022 10 p.m. EDT",13137,12830,11893,-1244
ISNE,"5/26/2022 11 p.m. EDT",12102,11750,10693,-1409
ISNE,"5/27/2022 12 a.m. EDT",11084,10780,9421,-1663
ISNE,"5/27/2022 1 a.m. EDT",10718,10390,9024,-1694
ISNE,"5/27/2022 2 a.m. EDT",10279,9980,8969,-1310
ISNE,"5/27/2022 3 a.m. EDT",10051,9750,8755,-1296
ISNE,"5/27/2022 4 a.m. EDT",9983,9690,8727,-1256
ISNE,"5/27/2022 5 a.m. EDT",10204,9900,8884,-1320
ISNE,"5/27/2022 6 a.m. EDT",10820,10550,9457,-1363
ISNE,"5/27/2022 7 a.m. EDT",11658,11690,10528,-1130
ISNE,"5/27/2022 8 a.m. EDT",12662,12620,11572,-1090
ISNE,"5/27/2022 9 a.m. EDT",13113,13120,11870,-1243
ISNE,"5/27/2022 10 a.m. EDT",13329,13340,11928,-1401
ISNE,"5/27/2022 11 a.m. EDT",13510,13520,11885,-1625
ISNE,"5/27/2022 12 p.m. EDT",13530,13480,11837,-1693
ISNE,"5/27/2022 1 p.m. EDT",13384,13380,11814,-1570
ISNE,"5/27/2022 2 p.m. EDT",13504,13600,12348,-1156
ISNE,"5/27/2022 3 p.m. EDT",13652,13750,12675,-977
ISNE,"5/27/2022 4 p.m. EDT",14260,14290,13235,-1025
ISNE,"5/27/2022 5 p.m. EDT",15160,15070,13803,-1357
ISNE,"5/27/2022 6 p.m. EDT",15680,15570,14079,-1601
ISNE,"5/27/2022 7 p.m. EDT",15566,15800,13614,-1952
ISNE,"5/27/2022 8 p.m. EDT",15309,15600,13317,-1992
ISNE,"5/27/2022 9 p.m. EDT",15080,15380,13187,-1893
ISNE,"5/27/2022 10 p.m. EDT",14378,14610,12576,-1802
ISNE,"5/27/2022 11 p.m. EDT",13344,13570,11640,-1704
ISNE,"5/28/2022 12 a.m. EDT",12325,12470,10097,-2228
ISNE,"5/28/2022 1 a.m. EDT",11733,11290,9299,-2434
ISNE,"5/28/2022 2 a.m. EDT",11201,10710,8971,-2230
ISNE,"5/28/2022 3 a.m. EDT",10938,10450,8527,-2411
ISNE,"5/28/2022 4 a.m. EDT",10910,10300,8555,-2355
ISNE,"5/28/2022 5 a.m. EDT",10896,10250,8419,-2477
ISNE,"5/28/2022 6 a.m. EDT",10994,10310,8431,-2563
ISNE,"5/28/2022 7 a.m. EDT",11277,10680,8724,-2553
ISNE,"5/28/2022 8 a.m. EDT",11720,11340,9214,-2506
ISNE,"5/28/2022 9 a.m. EDT",11887,11890,9510,-2377
ISNE,"5/28/2022 10 a.m. EDT",12510,12220,10118,-2392
ISNE,"5/28/2022 11 a.m. EDT",12514,12370,10132,-2382
ISNE,"5/28/2022 12 p.m. EDT",12590,12310,10276,-2314
ISNE,"5/28/2022 1 p.m. EDT",12662,12190,10480,-2182
ISNE,"5/28/2022 2 p.m. EDT",12971,12400,10910,-2061
ISNE,"5/28/2022 3 p.m. EDT",13228,12530,11013,-2215
ISNE,"5/28/2022 4 p.m. EDT",13275,12790,10872,-2403
ISNE,"5/28/2022 5 p.m. EDT",13268,13040,10735,-2533
ISNE,"5/28/2022 6 p.m. EDT",13416,13540,11040,-2376
ISNE,"5/28/2022 7 p.m. EDT",13614,13870,11170,-2444
ISNE,"5/28/2022 8 p.m. EDT",13546,13820,11225,-2321
ISNE,"5/28/2022 9 p.m. EDT",13508,13800,11222,-2286
ISNE,"5/28/2022 10 p.m. EDT",13093,13400,10824,-2269
ISNE,"5/28/2022 11 p.m. EDT",12227,12550,9909,-2318
ISNE,"5/29/2022 12 a.m. EDT",11431,11600,9009,-2422
ISNE,"5/29/2022 1 a.m. EDT",10739,10490,7961,-2778
ISNE,"5/29/2022 2 a.m. EDT",10161,9920,7215,-2946
ISNE,"5/29/2022 3 a.m. EDT",9766,9540,6891,-2875
ISNE,"5/29/2022 4 a.m. EDT",9561,9340,6772,-2789
ISNE,"5/29/2022 5 a.m. EDT",9504,9220,6814,-2690
ISNE,"5/29/2022 6 a.m. EDT",9436,9170,6923,-2513
ISNE,"5/29/2022 7 a.m. EDT",9548,9240,7233,-2315
ISNE,"5/29/2022 8 a.m. EDT",9986,9300,7558,-2428
ISNE,"5/29/2022 9 a.m. EDT",9738,9370,7455,-2283
ISNE,"5/29/2022 10 a.m. EDT",9907,9560,7714,-2193
ISNE,"5/29/2022 11 a.m. EDT",9758,9770,7652,-2106
ISNE,"5/29/2022 12 p.m. EDT",9956,9900,8085,-1871
ISNE,"5/29/2022 1 p.m. EDT",10158,10130,8322,-1836
ISNE,"5/29/2022 2 p.m. EDT",10323,10380,8367,-1956
ISNE,"5/29/2022 3 p.m. EDT",10663,10780,8735,-1928
ISNE,"5/29/2022 4 p.m. EDT",11233,11470,9142,-2091
ISNE,"5/29/2022 5 p.m. EDT",12154,12580,9875,-2279
ISNE,"5/29/2022 6 p.m. EDT",13199,13720,11046,-2153
ISNE,"5/29/2022 7 p.m. EDT",13669,14300,11669,-2000
ISNE,"5/29/2022 8 p.m. EDT",13682,14500,11756,-1926
ISNE,"5/29/2022 9 p.m. EDT",13504,14350,11337,-2167
ISNE,"5/29/2022 10 p.m. EDT",13068,13320,11007,-2061
ISNE,"5/29/2022 11 p.m. EDT",12213,12260,10257,-1956
ISNE,"5/30/2022 12 a.m. EDT",11265,11250,9351,-1914
ISNE,"5/30/2022 1 a.m. EDT",10488,10510,8348,-2140
ISNE,"5/30/2022 2 a.m. EDT",9910,9940,7336,-2574
ISNE,"5/30/2022 3 a.m. EDT",9766,9600,7096,-2670
ISNE,"5/30/2022 4 a.m. EDT",9719,9440,7064,-2655
ISNE,"5/30/2022 5 a.m. EDT",9712,9440,7317,-2395
ISNE,"5/30/2022 6 a.m. EDT",9758,9480,7528,-2230
ISNE,"5/30/2022 7 a.m. EDT",9849,9740,7529,-2320
ISNE,"5/30/2022 8 a.m. EDT",9917,9970,7415,-2502
ISNE,"5/30/2022 9 a.m. EDT",10109,10150,7739,-2370
ISNE,"5/30/2022 10 a.m. EDT",10373,10410,8239,-2134
ISNE,"5/30/2022 11 a.m. EDT",10727,10780,8616,-2111
ISNE,"5/30/2022 12 p.m. EDT",11206,11250,9030,-2176
ISNE,"5/30/2022 1 p.m. EDT",11795,11850,9651,-2144
ISNE,"5/30/2022 2 p.m. EDT",12421,12480,10195,-2226
ISNE,"5/30/2022 3 p.m. EDT",13039,13100,10781,-2258
ISNE,"5/30/2022 4 p.m. EDT",14018,14100,12132,-1886
ISNE,"5/30/2022 5 p.m. EDT",15374,15470,13503,-1871
ISNE,"5/30/2022 6 p.m. EDT",16647,16640,14719,-1928
ISNE,"5/30/2022 7 p.m. EDT",17245,17190,14951,-2294
ISNE,"5/30/2022 8 p.m. EDT",17130,17090,14437,-2693
ISNE,"5/30/2022 9 p.m. EDT",16875,16800,14179,-2696
ISNE,"5/30/2022 10 p.m. EDT",16104,15940,13321,-2783
ISNE,"5/30/2022 11 p.m. EDT",14709,14590,12023,-2686
ISNE,"5/31/2022 12 a.m. EDT",13405,13310,10731,-2674
ISNE,"5/31/2022 1 a.m. EDT",12569,12480,10157,-2412
ISNE,"5/31/2022 2 a.m. EDT",12166,11860,10102,-2064
ISNE,"5/31/2022 3 a.m. EDT",11789,11500,9743,-2046
ISNE,"5/31/2022 4 a.m. EDT",11814,11340,9639,-2175
ISNE,"5/31/2022 5 a.m. EDT",12036,11510,9954,-2082
ISNE,"5/31/2022 6 a.m. EDT",12317,12120,10474,-1843
ISNE,"5/31/2022 7 a.m. EDT",13232,13300,11420,-1812
ISNE,"5/31/2022 8 a.m. EDT",14228,14270,12505,-1723
ISNE,"5/31/2022 9 a.m. EDT",14555,14680,12862,-1693
ISNE,"5/31/2022 10 a.m. EDT",14538,14520,13105,-1433
ISNE,"5/31/2022 11 a.m. EDT",14418,14380,13274,-1144
ISNE,"5/31/2022 12 p.m. EDT",14710,14400,13516,-1194
ISNE,"5/31/2022 1 p.m. EDT",14655,14410,13584,-1071
ISNE,"5/31/2022 2 p.m. EDT",14717,14450,13643,-1074
ISNE,"5/31/2022 3 p.m. EDT",14903,14730,13775,-1128
ISNE,"5/31/2022 4 p.m. EDT",15317,14930,14225,-1092
ISNE,"5/31/2022 5 p.m. EDT",15975,15460,14864,-1111
ISNE,"5/31/2022 6 p.m. EDT",16524,15640,15347,-1177
ISNE,"5/31/2022 7 p.m. EDT",16522,16050,15351,-1171
ISNE,"5/31/2022 8 p.m. EDT",16057,15620,14772,-1285
ISNE,"5/31/2022 9 p.m. EDT",15528,15100,14076,-1452
ISNE,"5/31/2022 10 p.m. EDT",14551,14250,13117,-1434
ISNE,"5/31/2022 11 p.m. EDT",13121,12960,11454,-1667
ISNE,"6/1/2022 12 a.m. EDT",11825,11810,9719,-2106
