"BA Code","Timestamp (Hour Ending)","Demand (MWh)","Demand Forecast (MWh)","Net Generation (MWh)","Total Interchange (MWh)"
ISNE,"12/1/2022 12 a.m. EST",11751,11490,9632,-2119
ISNE,"12/1/2022 1 a.m. EST",11700,10790,9690,-2010
ISNE,"12/1/2022 2 a.m. EST",11546,10510,9459,-2087
ISNE,"12/1/2022 3 a.m. EST",11457,10420,9415,-2042
ISNE,"12/1/2022 4 a.m. EST",11557,10520,9511,-2046
ISNE,"12/1/2022 5 a.m. EST",11678,10920,9694,-1984
ISNE,"12/1/2022 6 a.m. EST",12380,11930,10800,-1580
ISNE,"12/1/2022 7 a.m. EST",13468,13530,11840,-1628
ISNE,"12/1/2022 8 a.m. EST",14279,14470,12729,-1550
ISNE,"12/1/2022 9 a.m. EST",13810,13730,12318,-1492
ISNE,"12/1/2022 10 a.m. EST",13026,13010,11550,-1476
ISNE,"12/1/2022 11 a.m. EST",12632,12560,10680,-1952
ISNE,"12/1/2022 12 p.m. EST",12584,12510,10673,-1911
ISNE,"12/1/2022 1 p.m. EST",12889,12770,11181,-1708
ISNE,"12/1/2022 2 p.m. EST",13324,13040,11551,-1773
ISNE,"12/1/2022 3 p.m. EST",13822,13550,11879,-1943
ISNE,"12/1/2022 4 p.m. EST",14640,14420,12866,-1774
ISNE,"12/1/2022 5 p.m. EST",15774,15830,13821,-1953
ISNE,"12/1/2022 6 p.m. EST",16450,16660,14217,-2233
ISNE,"12/1/2022 7 p.m. EST",16278,16460,14239,-2039
ISNE,"12/1/2022 8 p.m. EST",15896,16040,13845,-2051
ISNE,"12/1/2022 9 p.m. EST",15337,15450,13127,-2210
ISNE,"12/1/2022 10 p.m. EST",14507,14660,12288,-2219
ISNE,"12/1/2022 11 p.m. EST",13427,13530,10950,-2477
ISNE,"12/2/2022 12 a.m. EST",12436,12550,9776,-2660
ISNE,"12/2/2022 1 a.m. EST",11860,11830,9186,-2674
ISNE,"12/2/2022 2 a.m. EST",12030,11490,9089,-2941
ISNE,"12/2/2022 3 a.m. EST",11913,11360,8986,-2927
ISNE,"12/2/2022 4 a.m. EST",11926,11400,8852,-3074
ISNE,"12/2/2022 5 a.m. EST",12042,11760,9104,-2938
ISNE,"12/2/2022 6 a.m. EST",12638,12690,10206,-2432
ISNE,"12/2/2022 7 a.m. EST",14100,14180,12213,-1887
ISNE,"12/2/2022 8 a.m. EST",14854,14890,13342,-1512
ISNE,"12/2/2022 9 a.m. EST",14317,14290,12826,-1491
ISNE,"12/2/2022 10 a.m. EST",13214,13340,11547,-1667
ISNE,"12/2/2022 11 a.m. EST",12606,12610,11087,-1519
ISNE,"12/2/2022 12 p.m. EST",12248,12110,10615,-1633
ISNE,"12/2/2022 1 p.m. EST",12479,12020,10959,-1520
ISNE,"12/2/2022 2 p.m. EST",12653,12230,11047,-1606
ISNE,"12/2/2022 3 p.m. EST",13323,12940,11990,-1333
ISNE,"12/2/2022 4 p.m. EST",14089,14010,12719,-1370
ISNE,"12/2/2022 5 p.m. EST",15207,15310,13813,-1394
ISNE,"12/2/2022 6 p.m. EST",15707,16050,14290,-1417
ISNE,"12/2/2022 7 p.m. EST",15420,15810,14128,-1292
ISNE,"12/2/2022 8 p.m. EST",15011,15320,13426,-1585
ISNE,"12/2/2022 9 p.m. EST",14483,14710,12501,-1982
ISNE,"12/2/2022 10 p.m. EST",13781,14020,11591,-2190
ISNE,"12/2/2022 11 p.m. EST",12845,13070,10636,-2209
ISNE,"12/3/2022 12 a.m. EST",11925,12160,9911,-2014
ISNE,"12/3/2022 1 a.m. EST",11869,11230,8996,-2873
ISNE,"12/3/2022 2 a.m. EST",11557,10810,8486,-3071
ISNE,"12/3/2022 3 a.m. EST",11497,10570,8434,-3063
ISNE,"12/3/2022 4 a.m. EST",11522,10460,8773,-2749
ISNE,"12/3/2022 5 a.m. EST",11569,10510,8770,-2799
ISNE,"12/3/2022 6 a.m. EST",11863,10820,8703,-3160
ISNE,"12/3/2022 7 a.m. EST",12389,11390,9301,-3088
ISNE,"12/3/2022 8 a.m. EST",12322,12000,9479,-2843
ISNE,"12/3/2022 9 a.m. EST",12871,12640,10112,-2759
ISNE,"12/3/2022 10 a.m. EST",13204,13230,10414,-2790
ISNE,"12/3/2022 11 a.m. EST",13484,13560,10824,-2660
ISNE,"12/3/2022 12 p.m. EST",13643,13690,11012,-2631
ISNE,"12/3/2022 1 p.m. EST",13661,13690,10813,-2848
ISNE,"12/3/2022 2 p.m. EST",13626,13630,10857,-2769
ISNE,"12/3/2022 3 p.m. EST",13559,13590,10947,-2612
ISNE,"12/3/2022 4 p.m. EST",13608,13790,10967,-2641
ISNE,"12/3/2022 5 p.m. EST",14082,14490,10697,-3385
ISNE,"12/3/2022 6 p.m. EST",14309,14790,11222,-3087
ISNE,"12/3/2022 7 p.m. EST",13954,14510,11248,-2706
ISNE,"12/3/2022 8 p.m. EST",13493,13930,11212,-2281
ISNE,"12/3/2022 9 p.m. EST",13047,13440,10659,-2388
ISNE,"12/3/2022 10 p.m. EST",12530,12940,9925,-2605
ISNE,"12/3/2022 11 p.m. EST",12296,12180,9745,-2551
ISNE,"12/4/2022 12 a.m. EST",11648,11440,9148,-2500
ISNE,"12/4/2022 1 a.m. EST",10660,10670,8446,-2214
ISNE,"12/4/2022 2 a.m. EST",10308,10350,8225,-2083
ISNE,"12/4/2022 3 a.m. EST",10137,10200,7949,-2188
ISNE,"12/4/2022 4 a.m. EST",10119,10180,7942,-2177
ISNE,"12/4/2022 5 a.m. EST",10486,10340,8168,-2318
ISNE,"12/4/2022 6 a.m. EST",10659,10690,8562,-2097
ISNE,"12/4/2022 7 a.m. EST",11247,11290,9016,-2231
ISNE,"12/4/2022 8 a.m. EST",11763,11700,9307,-2456
ISNE,"12/4/2022 9 a.m. EST",11772,11840,8876,-2896
ISNE,"12/4/2022 10 a.m. EST",11524,11390,8576,-2948
ISNE,"12/4/2022 11 a.m. EST",11221,11070,8348,-2873
ISNE,"12/4/2022 12 p.m. EST",10986,11180,8294,-2692
ISNE,"12/4/2022 1 p.m. EST",11325,11450,8924,-2401
ISNE,"12/4/2022 2 p.m. EST",11951,11900,9161,-2790
ISNE,"12/4/2022 3 p.m. EST",12827,12650,9774,-3053
ISNE,"12/4/2022 4 p.m. EST",13729,13600,10317,-3412
ISNE,"12/4/2022 5 p.m. EST",14957,15050,11426,-3531
ISNE,"12/4/2022 6 p.m. EST",15663,15940,12451,-3212
ISNE,"12/4/2022 7 p.m. EST",15573,15740,12328,-3245
ISNE,"12/4/2022 8 p.m. EST",15258,15320,12021,-3237
ISNE,"12/4/2022 9 p.m. EST",14771,14810,11877,-2894
ISNE,"12/4/2022 10 p.m. EST",14009,14030,10988,-3021
ISNE,"12/4/2022 11 p.m. EST",12991,13070,9976,-3015
ISNE,"12/5/2022 12 a.m. EST",12175,12210,9301,-2874
ISNE,"12/5/2022 1 a.m. EST",12112,11620,9288,-2824
ISNE,"12/5/2022 2 a.m. EST",11868,11330,8962,-2906
ISNE,"12/5/2022 3 a.m. EST",12021,11250,9083,-2938
ISNE,"12/5/2022 4 a.m. EST",12157,11370,9123,-3034
ISNE,"12/5/2022 5 a.m. EST",12441,11770,9281,-3160
ISNE,"12/5/2022 6 a.m. EST",12794,12650,9806,-2988
ISNE,"12/5/2022 7 a.m. EST",14329,14060,11566,-2763
ISNE,"12/5/2022 8 a.m. EST",15185,14740,12746,-2439
ISNE,"12/5/2022 9 a.m. EST",14578,14260,12068,-2510
ISNE,"12/5/2022 10 a.m. EST",13344,13290,10871,-2473
ISNE,"12/5/2022 11 a.m. EST",12476,12620,9882,-2594
ISNE,"12/5/2022 12 p.m. EST",12418,12290,9705,-2713
ISNE,"12/5/2022 1 p.m. EST",12617,12220,10254,-2363
ISNE,"12/5/2022 2 p.m. EST",12815,12490,10566,-2249
ISNE,"12/5/2022 3 p.m. EST",13616,13160,11351,-2265
ISNE,"12/5/2022 4 p.m. EST",14426,14260,11638,-2788
ISNE,"12/5/2022 5 p.m. EST",15636,15660,12764,-2872
ISNE,"12/5/2022 6 p.m. EST",16372,16540,13793,-2579
ISNE,"12/5/2022 7 p.m. EST",16210,16350,13484,-2726
ISNE,"12/5/2022 8 p.m. EST",15772,15870,13088,-2684
ISNE,"12/5/2022 9 p.m. EST",15128,15230,12323,-2805
ISNE,"12/5/2022 10 p.m. EST",14209,14320,11357,-2852
ISNE,"12/5/2022 11 p.m. EST",13068,13150,10438,-2630
ISNE,"12/6/2022 12 a.m. EST",12035,12150,9723,-2312
ISNE,"12/6/2022 1 a.m. EST",11358,11380,9477,-1881
ISNE,"12/6/2022 2 a.m. EST",11245,11030,9446,-1799
ISNE,"12/6/2022 3 a.m. EST",11087,10790,9254,-1833
ISNE,"12/6/2022 4 a.m. EST",11072,10800,9360,-1712
ISNE,"12/6/2022 5 a.m. EST",11581,11050,9404,-2177
ISNE,"12/6/2022 6 a.m. EST",12202,11930,10096,-2106
ISNE,"12/6/2022 7 a.m. EST",13429,13290,11104,-2325
ISNE,"12/6/2022 8 a.m. EST",14291,14090,11894,-2397
ISNE,"12/6/2022 9 a.m. EST",14229,14190,12291,-1938
ISNE,"12/6/2022 10 a.m. EST",13976,13990,11882,-2094
ISNE,"12/6/2022 11 a.m. EST",13799,13890,11899,-1900
ISNE,"12/6/2022 12 p.m. EST",13680,13840,11496,-2184
ISNE,"12/6/2022 1 p.m. EST",13680,13800,11588,-2092
ISNE,"12/6/2022 2 p.m. EST",13893,14020,11990,-1903
ISNE,"12/6/2022 3 p.m. EST",14015,14140,11833,-2182
ISNE,"12/6/2022 4 p.m. EST",14385,14540,11845,-2540
ISNE,"12/6/2022 5 p.m. EST",15276,15440,12713,-2563
ISNE,"12/6/2022 6 p.m. EST",15774,16010,13017,-2757
ISNE,"12/6/2022 7 p.m. EST",15522,15690,12799,-2723
ISNE,"12/6/2022 8 p.m. EST",14990,15140,12109,-2881
ISNE,"12/6/2022 9 p.m. EST",14276,14450,11684,-2592
ISNE,"12/6/2022 10 p.m. EST",13330,13490,10779,-2551
ISNE,"12/6/2022 11 p.m. EST",12205,12340,9953,-2252
ISNE,"12/7/2022 12 a.m. EST",11170,11350,9294,-1876
ISNE,"12/7/2022 1 a.m. EST",10502,10730,8689,-1813
ISNE,"12/7/2022 2 a.m. EST",10674,10330,8354,-2320
ISNE,"12/7/2022 3 a.m. EST",10761,10140,8520,-2241
ISNE,"12/7/2022 4 a.m. EST",10716,9900,8563,-2153
ISNE,"12/7/2022 5 a.m. EST",10848,10190,8886,-1962
ISNE,"12/7/2022 6 a.m. EST",11375,11050,9308,-2067
ISNE,"12/7/2022 7 a.m. EST",12546,12580,10384,-2162
ISNE,"12/7/2022 8 a.m. EST",13738,13490,11213,-2525
ISNE,"12/7/2022 9 a.m. EST",14096,14040,11616,-2480
ISNE,"12/7/2022 10 a.m. EST",14182,14240,11593,-2589
ISNE,"12/7/2022 11 a.m. EST",14188,14360,11617,-2571
ISNE,"12/7/2022 12 p.m. EST",14249,14410,11567,-2682
ISNE,"12/7/2022 1 p.m. EST",14207,14370,11539,-2668
ISNE,"12/7/2022 2 p.m. EST",14248,14390,11379,-2869
ISNE,"12/7/2022 3 p.m. EST",14278,14380,11496,-2782
ISNE,"12/7/2022 4 p.m. EST",14389,14590,11312,-3077
ISNE,"12/7/2022 5 p.m. EST",15034,15350,12279,-2755
ISNE,"12/7/2022 6 p.m. EST",15442,15870,12610,-2832
ISNE,"12/7/2022 7 p.m. EST",15152,15490,12255,-2897
ISNE,"12/7/2022 8 p.m. EST",14615,14940,11865,-2750
ISNE,"12/7/2022 9 p.m. EST",13958,14270,11312,-2646
ISNE,"12/7/2022 10 p.m. EST",13050,13360,10378,-2672
ISNE,"12/7/2022 11 p.m. EST",11922,12220,9366,-2556
ISNE,"12/8/2022 12 a.m. EST",10951,11220,8415,-2536
ISNE,"12/8/2022 1 a.m. EST",10628,10490,8028,-2600
ISNE,"12/8/2022 2 a.m. EST",10817,10060,8166,-2651
ISNE,"12/8/2022 3 a.m. EST",10778,9920,8242,-2536
ISNE,"12/8/2022 4 a.m. EST",10767,9690,8270,-2497
ISNE,"12/8/2022 5 a.m. EST",11032,10020,8719,-2313
ISNE,"12/8/2022 6 a.m. EST",11246,10910,9034,-2212
ISNE,"12/8/2022 7 a.m. EST",12604,12570,9863,-2741
ISNE,"12/8/2022 8 a.m. EST",13219,13120,10446,-2773
ISNE,"12/8/2022 9 a.m. EST",13157,12900,10439,-2718
ISNE,"12/8/2022 10 a.m. EST",12926,12400,10104,-2822
ISNE,"12/8/2022 11 a.m. EST",12476,11910,10129,-2347
ISNE,"12/8/2022 12 p.m. EST",12042,11790,10041,-2001
ISNE,"12/8/2022 1 p.m. EST",12419,11930,10522,-1897
ISNE,"12/8/2022 2 p.m. EST",12584,12170,10656,-1928
ISNE,"12/8/2022 3 p.m. EST",12992,12850,10894,-2098
ISNE,"12/8/2022 4 p.m. EST",13656,13610,11190,-2466
ISNE,"12/8/2022 5 p.m. EST",14883,15010,12285,-2598
ISNE,"12/8/2022 6 p.m. EST",15604,15760,13180,-2424
ISNE,"12/8/2022 7 p.m. EST",15493,15670,12842,-2651
ISNE,"12/8/2022 8 p.m. EST",15182,15260,12660,-2522
ISNE,"12/8/2022 9 p.m. EST",14676,14660,11899,-2777
ISNE,"12/8/2022 10 p.m. EST",14373,13880,11524,-2849
ISNE,"12/8/2022 11 p.m. EST",13526,12890,10875,-2651
ISNE,"12/9/2022 12 a.m. EST",12582,11960,10009,-2573
ISNE,"12/9/2022 1 a.m. EST",12064,11370,9604,-2460
ISNE,"12/9/2022 2 a.m. EST",11849,11030,9379,-2470
ISNE,"12/9/2022 3 a.m. EST",11627,10910,9119,-2508
ISNE,"12/9/2022 4 a.m. EST",11944,10980,9261,-2683
ISNE,"12/9/2022 5 a.m. EST",12290,11280,9791,-2499
ISNE,"12/9/2022 6 a.m. EST",12934,12260,10121,-2813
ISNE,"12/9/2022 7 a.m. EST",13756,13800,10648,-3108
ISNE,"12/9/2022 8 a.m. EST",14596,14490,11381,-3215
ISNE,"12/9/2022 9 a.m. EST",14110,13890,11304,-2806
ISNE,"12/9/2022 10 a.m. EST",12984,12730,10590,-2394
ISNE,"12/9/2022 11 a.m. EST",12120,12160,9917,-2203
ISNE,"12/9/2022 12 p.m. EST",11667,11830,9471,-2196
ISNE,"12/9/2022 1 p.m. EST",11779,11670,9554,-2225
ISNE,"12/9/2022 2 p.m. EST",12333,12020,9847,-2486
ISNE,"12/9/2022 3 p.m. EST",13274,12870,10562,-2712
ISNE,"12/9/2022 4 p.m. EST",14283,14050,11317,-2966
ISNE,"12/9/2022 5 p.m. EST",15281,15370,12283,-2998
ISNE,"12/9/2022 6 p.m. EST",15969,16150,12974,-2995
ISNE,"12/9/2022 7 p.m. EST",15780,15880,12853,-2927
ISNE,"12/9/2022 8 p.m. EST",15454,15470,12486,-2968
ISNE,"12/9/2022 9 p.m. EST",14970,15000,11967,-3003
ISNE,"12/9/2022 10 p.m. EST",14321,14340,11439,-2882
ISNE,"12/9/2022 11 p.m. EST",13429,13450,10610,-2819
ISNE,"12/10/2022 12 a.m. EST",12574,12550,10179,-2395
ISNE,"12/10/2022 1 a.m. EST",12251,11940,10115,-2136
ISNE,"12/10/2022 2 a.m. EST",12249,11560,9447,-2802
ISNE,"12/10/2022 3 a.m. EST",12146,11430,9351,-2795
ISNE,"12/10/2022 4 a.m. EST",12087,11390,9268,-2819
ISNE,"12/10/2022 5 a.m. EST",11941,11550,9289,-2652
ISNE,"12/10/2022 6 a.m. EST",11849,11920,9394,-2455
ISNE,"12/10/2022 7 a.m. EST",12550,12600,10010,-2540
ISNE,"12/10/2022 8 a.m. EST",13259,13110,10628,-2631
ISNE,"12/10/2022 9 a.m. EST",13541,13390,11020,-2521
ISNE,"12/10/2022 10 a.m. EST",13285,13290,10692,-2593
ISNE,"12/10/2022 11 a.m. EST",12921,13090,9729,-3192
ISNE,"12/10/2022 12 p.m. EST",12760,13000,9571,-3189
ISNE,"12/10/2022 1 p.m. EST",12732,13080,9344,-3388
ISNE,"12/10/2022 2 p.m. EST",12826,13160,9421,-3405
ISNE,"12/10/2022 3 p.m. EST",13428,13580,9993,-3435
ISNE,"12/10/2022 4 p.m. EST",14306,14240,10957,-3349
ISNE,"12/10/2022 5 p.m. EST",15447,15450,12341,-3106
ISNE,"12/10/2022 6 p.m. EST",15942,16100,12752,-3190
ISNE,"12/10/2022 7 p.m. EST",15685,15750,12318,-3367
ISNE,"12/10/2022 8 p.m. EST",15287,15280,11703,-3584
ISNE,"12/10/2022 9 p.m. EST",14836,14800,11148,-3688
ISNE,"12/10/2022 10 p.m. EST",14234,14190,10624,-3610
ISNE,"12/10/2022 11 p.m. EST",13405,13370,9754,-3651
ISNE,"12/11/2022 12 a.m. EST",12813,12560,9240,-3573
ISNE,"12/11/2022 1 a.m. EST",12711,11980,9090,-3621
ISNE,"12/11/2022 2 a.m. EST",12430,11600,8859,-3571
ISNE,"12/11/2022 3 a.m. EST",12461,11400,8942,-3519
ISNE,"12/11/2022 4 a.m. EST",12403,11350,8944,-3459
ISNE,"12/11/2022 5 a.m. EST",12494,11460,9090,-3404
ISNE,"12/11/2022 6 a.m. EST",12285,11770,9084,-3201
ISNE,"12/11/2022 7 a.m. EST",12514,12330,9208,-3306
ISNE,"12/11/2022 8 a.m. EST",13118,12990,9787,-3331
ISNE,"12/11/2022 9 a.m. EST",13607,13650,10303,-3304
ISNE,"12/11/2022 10 a.m. EST",14116,14200,10790,-3326
ISNE,"12/11/2022 11 a.m. EST",14413,14350,10937,-3476
ISNE,"12/11/2022 12 p.m. EST",14555,14420,10990,-3565
ISNE,"12/11/2022 1 p.m. EST",14533,14460,11017,-3516
ISNE,"12/11/2022 2 p.m. EST",14778,14570,11049,-3729
ISNE,"12/11/2022 3 p.m. EST",15152,14730,11396,-3756
ISNE,"12/11/2022 4 p.m. EST",15647,15060,12066,-3581
ISNE,"12/11/2022 5 p.m. EST",16616,16130,13138,-3478
ISNE,"12/11/2022 6 p.m. EST",17153,16750,13892,-3261
ISNE,"12/11/2022 7 p.m. EST",16970,16390,13547,-3423
ISNE,"12/11/2022 8 p.m. EST",16509,15840,12687,-3822
ISNE,"12/11/2022 9 p.m. EST",15859,15270,11966,-3893
ISNE,"12/11/2022 10 p.m. EST",14992,14420,10944,-4048
ISNE,"12/11/2022 11 p.m. EST",13928,13430,9885,-4043
ISNE,"12/12/2022 12 a.m. EST",13334,12520,9225,-4109
ISNE,"12/12/2022 1 a.m. EST",13107,11910,9320,-3787
ISNE,"12/12/2022 2 a.m. EST",12763,11580,9238,-3525
ISNE,"12/12/2022 3 a.m. EST",12872,11490,9421,-3451
ISNE,"12/12/2022 4 a.m. EST",12922,11950,9430,-3492
ISNE,"12/12/2022 5 a.m. EST",13034,12250,9561,-3473
ISNE,"12/12/2022 6 a.m. EST",13405,13180,9995,-3410
ISNE,"12/12/2022 7 a.m. EST",14645,14430,11285,-3360
ISNE,"12/12/2022 8 a.m. EST",15718,15590,12456,-3262
ISNE,"12/12/2022 9 a.m. EST",16165,16360,12827,-3338
ISNE,"12/12/2022 10 a.m. EST",16156,16280,12725,-3431
ISNE,"12/12/2022 11 a.m. EST",15945,16070,12525,-3420
ISNE,"12/12/2022 12 p.m. EST",15591,15520,12179,-3412
ISNE,"12/12/2022 1 p.m. EST",15253,15200,11886,-3367
ISNE,"12/12/2022 2 p.m. EST",15120,15110,11730,-3390
ISNE,"12/12/2022 3 p.m. EST",15285,15050,11996,-3289
ISNE,"12/12/2022 4 p.m. EST",15784,15250,12503,-3281
ISNE,"12/12/2022 5 p.m. EST",16918,16470,13931,-2987
ISNE,"12/12/2022 6 p.m. EST",17710,17500,14600,-3110
ISNE,"12/12/2022 7 p.m. EST",17587,17380,14526,-3061
ISNE,"12/12/2022 8 p.m. EST",17267,16920,14122,-3145
ISNE,"12/12/2022 9 p.m. EST",16686,16340,13469,-3217
ISNE,"12/12/2022 10 p.m. EST",15776,15480,12542,-3234
ISNE,"12/12/2022 11 p.m. EST",14663,14370,11315,-3348
ISNE,"12/13/2022 12 a.m. EST",13859,13400,10289,-3570
ISNE,"12/13/2022 1 a.m. EST",13531,12950,9991,-3540
ISNE,"12/13/2022 2 a.m. EST",13648,12590,10067,-3581
ISNE,"12/13/2022 3 a.m. EST",13560,12480,10126,-3434
ISNE,"12/13/2022 4 a.m. EST",13619,12540,10174,-3445
ISNE,"12/13/2022 5 a.m. EST",13972,12800,10498,-3474
ISNE,"12/13/2022 6 a.m. EST",14664,13750,11210,-3454
ISNE,"12/13/2022 7 a.m. EST",15372,15320,12496,-2876
ISNE,"12/13/2022 8 a.m. EST",16255,16070,13186,-3069
ISNE,"12/13/2022 9 a.m. EST",16085,15580,12603,-3482
ISNE,"12/13/2022 10 a.m. EST",15398,15180,12112,-3286
ISNE,"12/13/2022 11 a.m. EST",14727,14510,11314,-3413
ISNE,"12/13/2022 12 p.m. EST",14252,14060,10922,-3330
ISNE,"12/13/2022 1 p.m. EST",14362,13810,11064,-3298
ISNE,"12/13/2022 2 p.m. EST",14526,13750,11533,-2993
ISNE,"12/13/2022 3 p.m. EST",14817,14250,12111,-2706
ISNE,"12/13/2022 4 p.m. EST",15467,15130,12758,-2709
ISNE,"12/13/2022 5 p.m. EST",16552,16710,13582,-2970
ISNE,"12/13/2022 6 p.m. EST",17262,17760,14293,-2969
ISNE,"12/13/2022 7 p.m. EST",17189,17540,14098,-3091
ISNE,"12/13/2022 8 p.m. EST",16896,17130,13885,-3011
ISNE,"12/13/2022 9 p.m. EST",16327,16430,13091,-3236
ISNE,"12/13/2022 10 p.m. EST",15462,15550,12125,-3337
ISNE,"12/13/2022 11 p.m. EST",14287,14440,10763,-3524
ISNE,"12/14/2022 12 a.m. EST",13486,13410,9901,-3585
ISNE,"12/14/2022 1 a.m. EST",13193,12610,10068,-3125
ISNE,"12/14/2022 2 a.m. EST",13100,12280,9851,-3249
ISNE,"12/14/2022 3 a.m. EST",13031,12200,9826,-3205
ISNE,"12/14/2022 4 a.m. EST",13127,12310,9907,-3220
ISNE,"12/14/2022 5 a.m. EST",13530,12700,10122,-3408
ISNE,"12/14/2022 6 a.m. EST",13908,13640,11003,-2905
ISNE,"12/14/2022 7 a.m. EST",15254,15190,12232,-3022
ISNE,"12/14/2022 8 a.m. EST",16210,16140,13268,-2942
ISNE,"12/14/2022 9 a.m. EST",15991,15880,12828,-3163
ISNE,"12/14/2022 10 a.m. EST",15165,15160,12414,-2751
ISNE,"12/14/2022 11 a.m. EST",14479,14550,12042,-2437
ISNE,"12/14/2022 12 p.m. EST",14148,14050,11754,-2394
ISNE,"12/14/2022 1 p.m. EST",14356,13780,11961,-2395
ISNE,"12/14/2022 2 p.m. EST",14659,13950,12242,-2417
ISNE,"12/14/2022 3 p.m. EST",14696,14520,12499,-2197
ISNE,"12/14/2022 4 p.m. EST",15574,15470,13287,-2287
ISNE,"12/14/2022 5 p.m. EST",16780,16690,14392,-2388
ISNE,"12/14/2022 6 p.m. EST",17411,17500,14869,-2542
ISNE,"12/14/2022 7 p.m. EST",17242,17300,14646,-2596
ISNE,"12/14/2022 8 p.m. EST",16955,16830,14331,-2624
ISNE,"12/14/2022 9 p.m. EST",16379,16180,13452,-2927
ISNE,"12/14/2022 10 p.m. EST",15441,15270,12161,-3280
ISNE,"12/14/2022 11 p.m. EST",14222,14120,10970,-3252
ISNE,"12/15/2022 12 a.m. EST",13120,13070,9758,-3362
ISNE,"12/15/2022 1 a.m. EST",12428,12410,9500,-2928
ISNE,"12/15/2022 2 a.m. EST",12548,12010,9598,-2950
ISNE,"12/15/2022 3 a.m. EST",12395,11830,9519,-2876
ISNE,"12/15/2022 4 a.m. EST",12358,11830,9679,-2679
ISNE,"12/15/2022 5 a.m. EST",12368,12180,9692,-2676
ISNE,"12/15/2022 6 a.m. EST",13007,13030,10562,-2445
ISNE,"12/15/2022 7 a.m. EST",14465,14380,11957,-2508
ISNE,"12/15/2022 8 a.m. EST",15366,15440,12714,-2652
ISNE,"12/15/2022 9 a.m. EST",15449,15480,12584,-2865
ISNE,"12/15/2022 10 a.m. EST",15321,15190,12620,-2701
ISNE,"12/15/2022 11 a.m. EST",15168,15070,12312,-2856
ISNE,"12/15/2022 12 p.m. EST",15104,15030,12065,-3039
ISNE,"12/15/2022 1 p.m. EST",15250,15000,12095,-3155
ISNE,"12/15/2022 2 p.m. EST",15480,15100,12177,-3303
ISNE,"12/15/2022 3 p.m. EST",15431,15200,12156,-3275
ISNE,"12/15/2022 4 p.m. EST",15598,15560,12490,-3108
ISNE,"12/15/2022 5 p.m. EST",16438,16510,13493,-2945
ISNE,"12/15/2022 6 p.m. EST",16842,17050,13933,-2909
ISNE,"12/15/2022 7 p.m. EST",16595,16700,13540,-3055
ISNE,"12/15/2022 8 p.m. EST",16243,16190,13085,-3158
ISNE,"12/15/2022 9 p.m. EST",15803,15600,12589,-3214
ISNE,"12/15/2022 10 p.m. EST",14703,14680,11528,-3175
ISNE,"12/15/2022 11 p.m. EST",13684,13500,10415,-3269
ISNE,"12/16/2022 12 a.m. EST",13162,12450,9634,-3528
ISNE,"12/16/2022 1 a.m. EST",12568,11750,9275,-3293
ISNE,"12/16/2022 2 a.m. EST",12273,11330,9081,-3192
ISNE,"12/16/2022 3 a.m. EST",12184,11120,9050,-3134
ISNE,"12/16/2022 4 a.m. EST",12169,11110,9076,-3093
ISNE,"12/16/2022 5 a.m. EST",12455,11390,9410,-3045
ISNE,"12/16/2022 6 a.m. EST",13058,12200,9872,-3186
ISNE,"12/16/2022 7 a.m. EST",13902,13520,10871,-3031
ISNE,"12/16/2022 8 a.m. EST",14632,14520,11812,-2820
ISNE,"12/16/2022 9 a.m. EST",15090,15080,12578,-2512
ISNE,"12/16/2022 10 a.m. EST",15427,15380,12638,-2789
ISNE,"12/16/2022 11 a.m. EST",15622,15550,12817,-2805
ISNE,"12/16/2022 12 p.m. EST",15680,15650,12799,-2881
ISNE,"12/16/2022 1 p.m. EST",15638,15620,12632,-3006
ISNE,"12/16/2022 2 p.m. EST",15566,15450,12498,-3068
ISNE,"12/16/2022 3 p.m. EST",15480,15370,12513,-2967
ISNE,"12/16/2022 4 p.m. EST",15620,15400,12740,-2880
ISNE,"12/16/2022 5 p.m. EST",16281,16190,13424,-2857
ISNE,"12/16/2022 6 p.m. EST",16559,16590,13831,-2728
ISNE,"12/16/2022 7 p.m. EST",16154,16090,13524,-2630
ISNE,"12/16/2022 8 p.m. EST",15564,15570,13086,-2478
ISNE,"12/16/2022 9 p.m. EST",14958,14920,12527,-2431
ISNE,"12/16/2022 10 p.m. EST",14186,14170,11835,-2351
ISNE,"12/16/2022 11 p.m. EST",13553,13200,10998,-2555
ISNE,"12/17/2022 12 a.m. EST",12816,12250,9967,-2849
ISNE,"12/17/2022 1 a.m. EST",12130,11420,8756,-3374
ISNE,"12/17/2022 2 a.m. EST",11919,11070,8373,-3546
ISNE,"12/17/2022 3 a.m. EST",11805,10790,8348,-3457
ISNE,"12/17/2022 4 a.m. EST",11888,10780,8487,-3401
ISNE,"12/17/2022 5 a.m. EST",11569,10940,8361,-3208
ISNE,"12/17/2022 6 a.m. EST",11624,11400,8550,-3074
ISNE,"12/17/2022 7 a.m. EST",12271,12050,9105,-3166
ISNE,"12/17/2022 8 a.m. EST",12956,12590,9911,-3045
ISNE,"12/17/2022 9 a.m. EST",13487,13260,10435,-3052
ISNE,"12/17/2022 10 a.m. EST",13282,13580,10349,-2933
ISNE,"12/17/2022 11 a.m. EST",13070,13470,10038,-3032
ISNE,"12/17/2022 12 p.m. EST",12897,13390,9817,-3080
ISNE,"12/17/2022 1 p.m. EST",12793,13300,9863,-2930
ISNE,"12/17/2022 2 p.m. EST",12994,13310,9978,-3016
ISNE,"12/17/2022 3 p.m. EST",13372,13630,10556,-2816
ISNE,"12/17/2022 4 p.m. EST",13842,14080,11135,-2707
ISNE,"12/17/2022 5 p.m. EST",14791,15160,12207,-2584
ISNE,"12/17/2022 6 p.m. EST",15358,15750,12887,-2471
ISNE,"12/17/2022 7 p.m. EST",15153,15320,12531,-2622
ISNE,"12/17/2022 8 p.m. EST",14778,14920,12230,-2548
ISNE,"12/17/2022 9 p.m. EST",14339,14420,11684,-2655
ISNE,"12/17/2022 10 p.m. EST",13788,13900,11217,-2571
ISNE,"12/17/2022 11 p.m. EST",13004,13150,10354,-2650
ISNE,"12/18/2022 12 a.m. EST",12195,12320,9702,-2493
ISNE,"12/18/2022 1 a.m. EST",11906,11830,9260,-2646
ISNE,"12/18/2022 2 a.m. EST",11737,11420,8822,-2915
ISNE,"12/18/2022 3 a.m. EST",11763,11240,8865,-2898
ISNE,"12/18/2022 4 a.m. EST",11470,10910,8721,-2749
ISNE,"12/18/2022 5 a.m. EST",11502,11020,8536,-2966
ISNE,"12/18/2022 6 a.m. EST",11303,11440,8547,-2756
ISNE,"12/18/2022 7 a.m. EST",11876,12010,8892,-2984
ISNE,"12/18/2022 8 a.m. EST",12471,12500,9583,-2888
ISNE,"12/18/2022 9 a.m. EST",12733,12660,10096,-2637
ISNE,"12/18/2022 10 a.m. EST",12699,12440,10029,-2670
ISNE,"12/18/2022 11 a.m. EST",12501,12410,9987,-2514
ISNE,"12/18/2022 12 p.m. EST",12302,12440,9956,-2346
ISNE,"12/18/2022 1 p.m. EST",12441,12670,10297,-2144
ISNE,"12/18/2022 2 p.m. EST",12770,12970,10623,-2147
ISNE,"12/18/2022 3 p.m. EST",13300,13460,11003,-2297
ISNE,"12/18/2022 4 p.m. EST",14096,14260,11677,-2419
ISNE,"12/18/2022 5 p.m. EST",15364,15550,12767,-2597
ISNE,"12/18/2022 6 p.m. EST",16142,16440,13619,-2523
ISNE,"12/18/2022 7 p.m. EST",16060,16290,13527,-2533
ISNE,"12/18/2022 8 p.m. EST",15747,15870,13249,-2498
ISNE,"12/18/2022 9 p.m. EST",15321,15330,12678,-2643
ISNE,"12/18/2022 10 p.m. EST",14519,14530,12121,-2398
ISNE,"12/18/2022 11 p.m. EST",13463,13540,11379,-2084
ISNE,"12/19/2022 12 a.m. EST",12633,12650,10132,-2501
ISNE,"12/19/2022 1 a.m. EST",12741,11940,10012,-2729
ISNE,"12/19/2022 2 a.m. EST",12693,11620,9774,-2919
ISNE,"12/19/2022 3 a.m. EST",12567,11510,9743,-2824
ISNE,"12/19/2022 4 a.m. EST",12624,11580,9667,-2957
ISNE,"12/19/2022 5 a.m. EST",13029,11990,9972,-3057
ISNE,"12/19/2022 6 a.m. EST",13433,12930,10612,-2821
ISNE,"12/19/2022 7 a.m. EST",14329,14400,11667,-2662
ISNE,"12/19/2022 8 a.m. EST",15317,15340,13159,-2158
ISNE,"12/19/2022 9 a.m. EST",15136,15140,12813,-2323
ISNE,"12/19/2022 10 a.m. EST",14418,14360,12195,-2223
ISNE,"12/19/2022 11 a.m. EST",14027,13650,11636,-2391
ISNE,"12/19/2022 12 p.m. EST",13939,13510,11592,-2347
ISNE,"12/19/2022 1 p.m. EST",14064,13480,11630,-2434
ISNE,"12/19/2022 2 p.m. EST",14492,13710,11883,-2609
ISNE,"12/19/2022 3 p.m. EST",14778,14240,12251,-2527
ISNE,"12/19/2022 4 p.m. EST",15344,15060,12684,-2660
ISNE,"12/19/2022 5 p.m. EST",16531,16280,14015,-2516
ISNE,"12/19/2022 6 p.m. EST",17301,17160,14852,-2449
ISNE,"12/19/2022 7 p.m. EST",17155,17030,14416,-2739
ISNE,"12/19/2022 8 p.m. EST",16748,16560,13723,-3025
ISNE,"12/19/2022 9 p.m. EST",16146,15880,13035,-3111
ISNE,"12/19/2022 10 p.m. EST",15233,15010,12348,-2885
ISNE,"12/19/2022 11 p.m. EST",14135,13880,11468,-2667
ISNE,"12/20/2022 12 a.m. EST",13263,12880,10668,-2595
ISNE,"12/20/2022 1 a.m. EST",12974,12300,10152,-2822
ISNE,"12/20/2022 2 a.m. EST",12701,11940,9996,-2705
ISNE,"12/20/2022 3 a.m. EST",12564,11810,10009,-2555
ISNE,"12/20/2022 4 a.m. EST",12742,11850,10572,-2170
ISNE,"12/20/2022 5 a.m. EST",12774,12200,10441,-2333
ISNE,"12/20/2022 6 a.m. EST",13453,13130,10745,-2708
ISNE,"12/20/2022 7 a.m. EST",14564,14630,11845,-2719
ISNE,"12/20/2022 8 a.m. EST",15501,15530,13168,-2333
ISNE,"12/20/2022 9 a.m. EST",15188,15190,12771,-2417
ISNE,"12/20/2022 10 a.m. EST",14225,14210,12238,-1987
ISNE,"12/20/2022 11 a.m. EST",13365,13490,11393,-1972
ISNE,"12/20/2022 12 p.m. EST",13238,13220,11180,-2058
ISNE,"12/20/2022 1 p.m. EST",13354,13110,11208,-2146
ISNE,"12/20/2022 2 p.m. EST",13681,13300,11140,-2541
ISNE,"12/20/2022 3 p.m. EST",14145,13960,11630,-2515
ISNE,"12/20/2022 4 p.m. EST",14933,14880,12787,-2146
ISNE,"12/20/2022 5 p.m. EST",16266,16230,14276,-1990
ISNE,"12/20/2022 6 p.m. EST",17110,17140,14968,-2142
ISNE,"12/20/2022 7 p.m. EST",17048,17080,14850,-2198
ISNE,"12/20/2022 8 p.m. EST",16740,16710,14715,-2025
ISNE,"12/20/2022 9 p.m. EST",16237,16090,14209,-2028
ISNE,"12/20/2022 10 p.m. EST",15405,15260,12980,-2425
ISNE,"12/20/2022 11 p.m. EST",14283,14260,11795,-2488
ISNE,"12/21/2022 12 a.m. EST",13214,13210,10570,-2644
ISNE,"12/21/2022 1 a.m. EST",12978,12590,9681,-3297
ISNE,"12/21/2022 2 a.m. EST",13057,12250,9773,-3284
ISNE,"12/21/2022 3 a.m. EST",12438,12120,9642,-2796
ISNE,"12/21/2022 4 a.m. EST",12459,12160,10287,-2172
ISNE,"12/21/2022 5 a.m. EST",12484,12520,10307,-2177
ISNE,"12/21/2022 6 a.m. EST",13400,13460,11119,-2281
ISNE,"12/21/2022 7 a.m. EST",14914,14980,12334,-2580
ISNE,"12/21/2022 8 a.m. EST",15898,15920,13786,-2112
ISNE,"12/21/2022 9 a.m. EST",15676,15670,13731,-1945
ISNE,"12/21/2022 10 a.m. EST",14726,14750,12389,-2337
ISNE,"12/21/2022 11 a.m. EST",14187,13940,11399,-2788
ISNE,"12/21/2022 12 p.m. EST",13709,13530,10899,-2810
ISNE,"12/21/2022 1 p.m. EST",13393,13380,10526,-2867
ISNE,"12/21/2022 2 p.m. EST",13611,13590,10795,-2816
ISNE,"12/21/2022 3 p.m. EST",14364,14080,11573,-2791
ISNE,"12/21/2022 4 p.m. EST",15258,15000,12574,-2684
ISNE,"12/21/2022 5 p.m. EST",16250,16300,13921,-2329
ISNE,"12/21/2022 6 p.m. EST",17067,17160,14811,-2256
ISNE,"12/21/2022 7 p.m. EST",16998,17060,14515,-2483
ISNE,"12/21/2022 8 p.m. EST",16725,16700,14229,-2496
ISNE,"12/21/2022 9 p.m. EST",16465,16090,14067,-2398
ISNE,"12/21/2022 10 p.m. EST",16185,15290,13587,-2598
ISNE,"12/21/2022 11 p.m. EST",15051,14150,12165,-2886
ISNE,"12/22/2022 12 a.m. EST",13975,13090,11499,-2476
ISNE,"12/22/2022 1 a.m. EST",13160,12590,10995,-2165
ISNE,"12/22/2022 2 a.m. EST",12305,12200,10161,-2144
ISNE,"12/22/2022 3 a.m. EST",12280,12070,10236,-2044
ISNE,"12/22/2022 4 a.m. EST",12596,12040,10091,-2505
ISNE,"12/22/2022 5 a.m. EST",12912,12340,10121,-2791
ISNE,"12/22/2022 6 a.m. EST",13545,13100,11629,-1916
ISNE,"12/22/2022 7 a.m. EST",14812,14520,13112,-1700
ISNE,"12/22/2022 8 a.m. EST",15703,15430,14045,-1658
ISNE,"12/22/2022 9 a.m. EST",15700,15590,14125,-1575
ISNE,"12/22/2022 10 a.m. EST",15463,15270,13824,-1639
ISNE,"12/22/2022 11 a.m. EST",15228,15090,13795,-1433
ISNE,"12/22/2022 12 p.m. EST",14877,15070,13539,-1338
ISNE,"12/22/2022 1 p.m. EST",15377,14880,13254,-2123
ISNE,"12/22/2022 2 p.m. EST",15228,15010,12942,-2286
ISNE,"12/22/2022 3 p.m. EST",15347,15310,12737,-2610
ISNE,"12/22/2022 4 p.m. EST",15629,15630,12920,-2709
ISNE,"12/22/2022 5 p.m. EST",16440,16400,14674,-1766
ISNE,"12/22/2022 6 p.m. EST",16851,16880,14741,-2110
ISNE,"12/22/2022 7 p.m. EST",16578,16610,14454,-2124
ISNE,"12/22/2022 8 p.m. EST",16145,16040,13732,-2413
ISNE,"12/22/2022 9 p.m. EST",15780,15390,13691,-2089
ISNE,"12/22/2022 10 p.m. EST",14860,14480,12628,-2232
ISNE,"12/22/2022 11 p.m. EST",14134,13340,11174,-2960
ISNE,"12/23/2022 12 a.m. EST",13239,12270,10433,-2806
ISNE,"12/23/2022 1 a.m. EST",12749,11660,9857,-2892
ISNE,"12/23/2022 2 a.m. EST",12232,11160,9316,-2916
ISNE,"12/23/2022 3 a.m. EST",11943,10880,8820,-3123
ISNE,"12/23/2022 4 a.m. EST",11809,10700,8807,-3002
ISNE,"12/23/2022 5 a.m. EST",11940,10970,9002,-2938
ISNE,"12/23/2022 6 a.m. EST",12299,11640,9319,-2980
ISNE,"12/23/2022 7 a.m. EST",12307,12750,9275,-3032
ISNE,"12/23/2022 8 a.m. EST",12965,13210,10319,-2646
ISNE,"12/23/2022 9 a.m. EST",13417,13780,10901,-2516
ISNE,"12/23/2022 10 a.m. EST",13675,14000,11440,-2235
ISNE,"12/23/2022 11 a.m. EST",13811,14060,11296,-2515
ISNE,"12/23/2022 12 p.m. EST",13945,13970,11534,-2411
ISNE,"12/23/2022 1 p.m. EST",13859,13850,11396,-2463
ISNE,"12/23/2022 2 p.m. EST",13796,13910,11204,-2592
ISNE,"12/23/2022 3 p.m. EST",13774,14220,11516,-2258
ISNE,"12/23/2022 4 p.m. EST",14042,14840,12006,-2036
ISNE,"12/23/2022 5 p.m. EST",14829,15820,12885,-1944
ISNE,"12/23/2022 6 p.m. EST",15296,16470,13626,-1670
ISNE,"12/23/2022 7 p.m. EST",15166,16160,13426,-1740
ISNE,"12/23/2022 8 p.m. EST",14989,15780,13142,-1847
ISNE,"12/23/2022 9 p.m. EST",14845,15620,12918,-1927
ISNE,"12/23/2022 10 p.m. EST",14443,15260,12511,-1932
ISNE,"12/23/2022 11 p.m. EST",13806,14510,12178,-1628
ISNE,"12/24/2022 12 a.m. EST",13148,13810,11334,-1814
ISNE,"12/24/2022 1 a.m. EST",12812,12670,10598,-2214
ISNE,"12/24/2022 2 a.m. EST",12991,12440,10525,-2466
ISNE,"12/24/2022 3 a.m. EST",13193,12360,10933,-2260
ISNE,"12/24/2022 4 a.m. EST",13223,12420,10932,-2291
ISNE,"12/24/2022 5 a.m. EST",13428,12620,11015,-2413
ISNE,"12/24/2022 6 a.m. EST",13607,13150,10981,-2626
ISNE,"12/24/2022 7 a.m. EST",14026,13760,11500,-2526
ISNE,"12/24/2022 8 a.m. EST",14548,14600,12717,-1831
ISNE,"12/24/2022 9 a.m. EST",14999,14860,13108,-1891
ISNE,"12/24/2022 10 a.m. EST",14927,15060,12785,-2142
ISNE,"12/24/2022 11 a.m. EST",14614,14600,12526,-2088
ISNE,"12/24/2022 12 p.m. EST",14477,14130,12078,-2399
ISNE,"12/24/2022 1 p.m. EST",14483,13920,12128,-2355
ISNE,"12/24/2022 2 p.m. EST",14834,14230,12553,-2281
ISNE,"12/24/2022 3 p.m. EST",15463,14800,13299,-2164
ISNE,"12/24/2022 4 p.m. EST",16243,15640,14559,-1684
ISNE,"12/24/2022 5 p.m. EST",17127,16950,15135,-1992
ISNE,"12/24/2022 6 p.m. EST",17382,17510,15438,-1944
ISNE,"12/24/2022 7 p.m. EST",17009,17100,14370,-2639
ISNE,"12/24/2022 8 p.m. EST",16710,16520,13928,-2782
ISNE,"12/24/2022 9 p.m. EST",16421,16070,13969,-2452
ISNE,"12/24/2022 10 p.m. EST",16074,15520,13343,-2731
ISNE,"12/24/2022 11 p.m. EST",15496,14870,13238,-2258
ISNE,"12/25/2022 12 a.m. EST",14960,14010,12641,-2319
ISNE,"12/25/2022 1 a.m. EST",14477,14160,12407,-2070
ISNE,"12/25/2022 2 a.m. EST",14318,13720,12361,-1957
ISNE,"12/25/2022 3 a.m. EST",14344,13500,12249,-2095
ISNE,"12/25/2022 4 a.m. EST",14428,13420,12303,-2125
ISNE,"12/25/2022 5 a.m. EST",14421,13450,12232,-2189
ISNE,"12/25/2022 6 a.m. EST",14202,13660,12126,-2076
ISNE,"12/25/2022 7 a.m. EST",14607,14060,12434,-2173
ISNE,"12/25/2022 8 a.m. EST",14893,14190,12846,-2047
ISNE,"12/25/2022 9 a.m. EST",15027,14070,12967,-2060
ISNE,"12/25/2022 10 a.m. EST",14675,14460,12394,-2281
ISNE,"12/25/2022 11 a.m. EST",14284,14180,11906,-2378
ISNE,"12/25/2022 12 p.m. EST",14175,13950,11401,-2774
ISNE,"12/25/2022 1 p.m. EST",13933,13870,11463,-2470
ISNE,"12/25/2022 2 p.m. EST",14213,14010,11641,-2572
ISNE,"12/25/2022 3 p.m. EST",14487,14410,11922,-2565
ISNE,"12/25/2022 4 p.m. EST",14733,15060,12214,-2519
ISNE,"12/25/2022 5 p.m. EST",15661,16330,13327,-2334
ISNE,"12/25/2022 6 p.m. EST",16107,16970,13537,-2570
ISNE,"12/25/2022 7 p.m. EST",15965,16770,13372,-2593
ISNE,"12/25/2022 8 p.m. EST",15798,16440,13298,-2500
ISNE,"12/25/2022 9 p.m. EST",15584,16000,13090,-2494
ISNE,"12/25/2022 10 p.m. EST",15194,15310,12651,-2543
ISNE,"12/25/2022 11 p.m. EST",14530,14540,12157,-2373
ISNE,"12/26/2022 12 a.m. EST",14312,13680,11686,-2626
ISNE,"12/26/2022 1 a.m. EST",14128,13210,11734,-2394
ISNE,"12/26/2022 2 a.m. EST",14021,12860,11936,-2085
ISNE,"12/26/2022 3 a.m. EST",13850,12720,11883,-1967
ISNE,"12/26/2022 4 a.m. EST",13857,12750,11892,-1965
ISNE,"12/26/2022 5 a.m. EST",14054,12990,12254,-1800
ISNE,"12/26/2022 6 a.m. EST",14062,13480,12234,-1828
ISNE,"12/26/2022 7 a.m. EST",14086,14240,12364,-1722
ISNE,"12/26/2022 8 a.m. EST",14537,14740,13028,-1509
ISNE,"12/26/2022 9 a.m. EST",14539,14550,12920,-1619
ISNE,"12/26/2022 10 a.m. EST",14057,14080,12463,-1594
ISNE,"12/26/2022 11 a.m. EST",13718,13730,11772,-1946
ISNE,"12/26/2022 12 p.m. EST",13492,13490,11506,-1986
ISNE,"12/26/2022 1 p.m. EST",13461,13390,11520,-1941
ISNE,"12/26/2022 2 p.m. EST",13447,13530,11507,-1940
ISNE,"12/26/2022 3 p.m. EST",14184,14260,11990,-2194
ISNE,"12/26/2022 4 p.m. EST",15184,15350,13115,-2069
ISNE,"12/26/2022 5 p.m. EST",16493,16670,14612,-1881
ISNE,"12/26/2022 6 p.m. EST",17155,17500,15596,-1559
ISNE,"12/26/2022 7 p.m. EST",16934,17360,14958,-1976
ISNE,"12/26/2022 8 p.m. EST",16480,16950,14482,-1998
ISNE,"12/26/2022 9 p.m. EST",15916,16390,14131,-1785
ISNE,"12/26/2022 10 p.m. EST",15151,15540,12901,-2250
ISNE,"12/26/2022 11 p.m. EST",14269,14440,12078,-2191
ISNE,"12/27/2022 12 a.m. EST",13483,13480,11479,-2004
ISNE,"12/27/2022 1 a.m. EST",12900,12610,11174,-1726
ISNE,"12/27/2022 2 a.m. EST",12519,12220,11086,-1433
ISNE,"12/27/2022 3 a.m. EST",12346,12070,10860,-1486
ISNE,"12/27/2022 4 a.m. EST",12385,12120,11037,-1348
ISNE,"12/27/2022 5 a.m. EST",12638,12390,11164,-1474
ISNE,"12/27/2022 6 a.m. EST",13001,13090,11622,-1379
ISNE,"12/27/2022 7 a.m. EST",14064,14160,12918,-1146
ISNE,"12/27/2022 8 a.m. EST",14998,15090,14026,-972
ISNE,"12/27/2022 9 a.m. EST",15461,15470,13964,-1497
ISNE,"12/27/2022 10 a.m. EST",15507,15550,13699,-1808
ISNE,"12/27/2022 11 a.m. EST",15092,15060,13099,-1993
ISNE,"12/27/2022 12 p.m. EST",14371,14120,12257,-2114
ISNE,"12/27/2022 1 p.m. EST",14164,13830,12105,-2059
ISNE,"12/27/2022 2 p.m. EST",14293,13810,12480,-1813
ISNE,"12/27/2022 3 p.m. EST",14699,14230,12776,-1923
ISNE,"12/27/2022 4 p.m. EST",15586,15160,13674,-1912
ISNE,"12/27/2022 5 p.m. EST",16704,16520,14810,-1894
ISNE,"12/27/2022 6 p.m. EST",17302,17470,15415,-1887
ISNE,"12/27/2022 7 p.m. EST",17122,17410,15377,-1745
ISNE,"12/27/2022 8 p.m. EST",16768,17090,14793,-1975
ISNE,"12/27/2022 9 p.m. EST",16240,16460,14159,-2081
ISNE,"12/27/2022 10 p.m. EST",15461,15580,13145,-2316
ISNE,"12/27/2022 11 p.m. EST",14460,14490,12101,-2359
ISNE,"12/28/2022 12 a.m. EST",13569,13470,11144,-2425
ISNE,"12/28/2022 1 a.m. EST",12978,12970,10371,-2607
ISNE,"12/28/2022 2 a.m. EST",13154,12620,10261,-2893
ISNE,"12/28/2022 3 a.m. EST",13014,12440,10340,-2674
ISNE,"12/28/2022 4 a.m. EST",13013,12440,10390,-2623
ISNE,"12/28/2022 5 a.m. EST",13222,12670,10652,-2570
ISNE,"12/28/2022 6 a.m. EST",13394,13350,11267,-2127
ISNE,"12/28/2022 7 a.m. EST",14323,14380,12408,-1915
ISNE,"12/28/2022 8 a.m. EST",15161,15240,13543,-1618
ISNE,"12/28/2022 9 a.m. EST",15517,15530,13837,-1680
ISNE,"12/28/2022 10 a.m. EST",15358,15320,13267,-2091
ISNE,"12/28/2022 11 a.m. EST",15169,14820,12352,-2817
ISNE,"12/28/2022 12 p.m. EST",15115,14460,12096,-3019
ISNE,"12/28/2022 1 p.m. EST",14839,14390,11681,-3158
ISNE,"12/28/2022 2 p.m. EST",14764,14450,11625,-3139
ISNE,"12/28/2022 3 p.m. EST",15207,14740,12160,-3047
ISNE,"12/28/2022 4 p.m. EST",15288,15220,12482,-2806
ISNE,"12/28/2022 5 p.m. EST",16186,16270,13424,-2762
ISNE,"12/28/2022 6 p.m. EST",16726,17030,14136,-2590
ISNE,"12/28/2022 7 p.m. EST",16418,16830,13782,-2636
ISNE,"12/28/2022 8 p.m. EST",15919,16370,13219,-2700
ISNE,"12/28/2022 9 p.m. EST",15294,15780,12400,-2894
ISNE,"12/28/2022 10 p.m. EST",14503,14910,11499,-3004
ISNE,"12/28/2022 11 p.m. EST",13516,13830,10383,-3133
ISNE,"12/29/2022 12 a.m. EST",12581,12850,9335,-3246
ISNE,"12/29/2022 1 a.m. EST",11966,11970,8570,-3396
ISNE,"12/29/2022 2 a.m. EST",11861,11610,8412,-3449
ISNE,"12/29/2022 3 a.m. EST",11674,11440,8197,-3477
ISNE,"12/29/2022 4 a.m. EST",11669,11430,8217,-3452
ISNE,"12/29/2022 5 a.m. EST",11923,11740,8517,-3406
ISNE,"12/29/2022 6 a.m. EST",12407,12460,9022,-3385
ISNE,"12/29/2022 7 a.m. EST",13489,13550,10013,-3476
ISNE,"12/29/2022 8 a.m. EST",14291,14330,11028,-3263
ISNE,"12/29/2022 9 a.m. EST",14383,14390,11184,-3199
ISNE,"12/29/2022 10 a.m. EST",13891,13900,10584,-3307
ISNE,"12/29/2022 11 a.m. EST",13397,13380,10215,-3182
ISNE,"12/29/2022 12 p.m. EST",13048,12910,10253,-2795
ISNE,"12/29/2022 1 p.m. EST",12956,12710,10314,-2642
ISNE,"12/29/2022 2 p.m. EST",13021,12920,10441,-2580
ISNE,"12/29/2022 3 p.m. EST",13439,13510,10849,-2590
ISNE,"12/29/2022 4 p.m. EST",13916,14310,11433,-2483
ISNE,"12/29/2022 5 p.m. EST",15083,15510,12448,-2635
ISNE,"12/29/2022 6 p.m. EST",15923,16380,13072,-2851
ISNE,"12/29/2022 7 p.m. EST",15725,16200,12719,-3006
ISNE,"12/29/2022 8 p.m. EST",15284,15820,12219,-3065
ISNE,"12/29/2022 9 p.m. EST",14778,15220,11752,-3026
ISNE,"12/29/2022 10 p.m. EST",14315,14490,11407,-2908
ISNE,"12/29/2022 11 p.m. EST",13259,13420,10519,-2740
ISNE,"12/30/2022 12 a.m. EST",12206,12480,9390,-2816
ISNE,"12/30/2022 1 a.m. EST",11508,11510,9305,-2203
ISNE,"12/30/2022 2 a.m. EST",11356,11050,9180,-2176
ISNE,"12/30/2022 3 a.m. EST",11159,10830,8865,-2294
ISNE,"12/30/2022 4 a.m. EST",11095,10780,8816,-2279
ISNE,"12/30/2022 5 a.m. EST",11296,10980,8994,-2302
ISNE,"12/30/2022 6 a.m. EST",11788,11570,9536,-2252
ISNE,"12/30/2022 7 a.m. EST",12731,12520,10138,-2593
ISNE,"12/30/2022 8 a.m. EST",13349,13260,10799,-2550
ISNE,"12/30/2022 9 a.m. EST",13369,13390,10822,-2547
ISNE,"12/30/2022 10 a.m. EST",12951,12860,10479,-2472
ISNE,"12/30/2022 11 a.m. EST",12421,12080,10253,-2168
ISNE,"12/30/2022 12 p.m. EST",12224,11790,10346,-1878
ISNE,"12/30/2022 1 p.m. EST",12257,11730,10259,-1998
ISNE,"12/30/2022 2 p.m. EST",12395,11970,10383,-2012
ISNE,"12/30/2022 3 p.m. EST",12651,12470,10492,-2159
ISNE,"12/30/2022 4 p.m. EST",13122,13380,10850,-2272
ISNE,"12/30/2022 5 p.m. EST",14042,14440,11616,-2426
ISNE,"12/30/2022 6 p.m. EST",14696,15310,12171,-2525
ISNE,"12/30/2022 7 p.m. EST",14414,15040,12022,-2392
ISNE,"12/30/2022 8 p.m. EST",14015,14440,11626,-2389
ISNE,"12/30/2022 9 p.m. EST",13760,13820,11142,-2618
ISNE,"12/30/2022 10 p.m. EST",12931,13210,10370,-2561
ISNE,"12/30/2022 11 p.m. EST",12101,12340,9664,-2437
ISNE,"12/31/2022 12 a.m. EST",11326,11480,8898,-2428
ISNE,"12/31/2022 1 a.m. EST",10664,10660,8915,-1749
ISNE,"12/31/2022 2 a.m. EST",10256,10260,8630,-1626
ISNE,"12/31/2022 3 a.m. EST",10310,10010,8820,-1490
ISNE,"12/31/2022 4 a.m. EST",10237,9910,8534,-1703
ISNE,"12/31/2022 5 a.m. EST",10542,9970,8490,-2052
ISNE,"12/31/2022 6 a.m. EST",11067,10230,9132,-1935
ISNE,"12/31/2022 7 a.m. EST",11208,10700,9381,-1827
ISNE,"12/31/2022 8 a.m. EST",11619,11230,9826,-1793
ISNE,"12/31/2022 9 a.m. EST",12013,11760,9896,-2117
ISNE,"12/31/2022 10 a.m. EST",12422,12130,9961,-2461
ISNE,"12/31/2022 11 a.m. EST",12674,12350,10197,-2477
ISNE,"12/31/2022 12 p.m. EST",13032,12530,10412,-2620
ISNE,"12/31/2022 1 p.m. EST",13147,12730,10710,-2437
ISNE,"12/31/2022 2 p.m. EST",13134,12780,10750,-2384
ISNE,"12/31/2022 3 p.m. EST",13223,12890,10905,-2318
ISNE,"12/31/2022 4 p.m. EST",13481,13170,10933,-2548
ISNE,"12/31/2022 5 p.m. EST",14134,14030,11416,-2718
ISNE,"12/31/2022 6 p.m. EST",14468,14430,11693,-2775
ISNE,"12/31/2022 7 p.m. EST",14029,14050,11202,-2827
ISNE,"12/31/2022 8 p.m. EST",13363,13470,10506,-2857
ISNE,"12/31/2022 9 p.m. EST",12770,12840,10124,-2646
ISNE,"12/31/2022 10 p.m. EST",12376,12290,10325,-2051
ISNE,"12/31/2022 11 p.m. EST",11510,11660,9579,-1931
ISNE,"1/1/2023 12 a.m. EST",10922,10910,9004,-1918
