"BA Code","Timestamp (Hour Ending)","Demand (MWh)","Demand Forecast (MWh)","Net Generation (MWh)","Total Interchange (MWh)"
ISNE,"9/1/2022 12 a.m. EDT",13206,13480,10825,-2381
ISNE,"9/1/2022 1 a.m. EDT",12580,12280,9598,-2982
ISNE,"9/1/2022 2 a.m. EDT",11955,11660,8960,-2995
ISNE,"9/1/2022 3 a.m. EDT",11557,11270,8697,-2860
ISNE,"9/1/2022 4 a.m. EDT",11600,11070,8690,-2910
ISNE,"9/1/2022 5 a.m. EDT",11727,11220,8804,-2923
ISNE,"9/1/2022 6 a.m. EDT",12354,11850,9513,-2841
ISNE,"9/1/2022 7 a.m. EDT",13064,12960,10399,-2665
ISNE,"9/1/2022 8 a.m. EDT",13438,13670,11010,-2428
ISNE,"9/1/2022 9 a.m. EDT",13477,13730,11233,-2244
ISNE,"9/1/2022 10 a.m. EDT",13328,13490,11327,-2001
ISNE,"9/1/2022 11 a.m. EDT",13278,13470,11462,-1816
ISNE,"9/1/2022 12 p.m. EDT",13336,13630,11939,-1397
ISNE,"9/1/2022 1 p.m. EDT",13441,13820,12033,-1408
ISNE,"9/1/2022 2 p.m. EDT",13745,13810,12061,-1684
ISNE,"9/1/2022 3 p.m. EDT",14163,14150,12745,-1418
ISNE,"9/1/2022 4 p.m. EDT",14756,14710,13463,-1293
ISNE,"9/1/2022 5 p.m. EDT",15646,15560,14363,-1283
ISNE,"9/1/2022 6 p.m. EDT",16469,16590,15056,-1413
ISNE,"9/1/2022 7 p.m. EDT",16633,16520,14994,-1639
ISNE,"9/1/2022 8 p.m. EDT",16264,16330,14481,-1783
ISNE,"9/1/2022 9 p.m. EDT",15703,15690,13543,-2160
ISNE,"9/1/2022 10 p.m. EDT",14609,14530,12410,-2199
ISNE,"9/1/2022 11 p.m. EDT",13335,13260,11133,-2202
ISNE,"9/2/2022 12 a.m. EDT",12160,12060,9667,-2493
ISNE,"9/2/2022 1 a.m. EDT",11600,11290,8870,-2730
ISNE,"9/2/2022 2 a.m. EDT",11006,10700,8419,-2587
ISNE,"9/2/2022 3 a.m. EDT",10857,10310,8153,-2704
ISNE,"9/2/2022 4 a.m. EDT",10671,10120,7763,-2908
ISNE,"9/2/2022 5 a.m. EDT",10741,10200,7863,-2878
ISNE,"9/2/2022 6 a.m. EDT",10732,10770,8000,-2732
ISNE,"9/2/2022 7 a.m. EDT",11594,11810,8974,-2620
ISNE,"9/2/2022 8 a.m. EDT",12068,12360,9481,-2587
ISNE,"9/2/2022 9 a.m. EDT",12047,12270,9618,-2429
ISNE,"9/2/2022 10 a.m. EDT",11712,11410,9581,-2131
ISNE,"9/2/2022 11 a.m. EDT",11447,11430,9595,-1852
ISNE,"9/2/2022 12 p.m. EDT",11406,11650,9855,-1551
ISNE,"9/2/2022 1 p.m. EDT",11290,11210,9941,-1349
ISNE,"9/2/2022 2 p.m. EDT",11573,11700,10227,-1346
ISNE,"9/2/2022 3 p.m. EDT",12266,12200,10972,-1294
ISNE,"9/2/2022 4 p.m. EDT",12826,12910,11466,-1360
ISNE,"9/2/2022 5 p.m. EDT",13787,14030,12137,-1650
ISNE,"9/2/2022 6 p.m. EDT",14784,15620,12564,-2220
ISNE,"9/2/2022 7 p.m. EDT",15093,15530,12670,-2423
ISNE,"9/2/2022 8 p.m. EDT",14810,15450,12116,-2694
ISNE,"9/2/2022 9 p.m. EDT",14342,14860,11637,-2705
ISNE,"9/2/2022 10 p.m. EDT",13532,14000,10960,-2572
ISNE,"9/2/2022 11 p.m. EDT",12535,12960,10191,-2344
ISNE,"9/3/2022 12 a.m. EDT",11577,11920,8968,-2609
ISNE,"9/3/2022 1 a.m. EDT",11048,11020,8481,-2567
ISNE,"9/3/2022 2 a.m. EDT",10830,10460,8548,-2282
ISNE,"9/3/2022 3 a.m. EDT",10755,10100,8418,-2337
ISNE,"9/3/2022 4 a.m. EDT",10578,9880,8179,-2399
ISNE,"9/3/2022 5 a.m. EDT",10551,9810,8267,-2284
ISNE,"9/3/2022 6 a.m. EDT",10713,10010,8257,-2456
ISNE,"9/3/2022 7 a.m. EDT",10966,10370,8628,-2338
ISNE,"9/3/2022 8 a.m. EDT",11239,10820,9070,-2169
ISNE,"9/3/2022 9 a.m. EDT",11023,11140,9336,-1687
ISNE,"9/3/2022 10 a.m. EDT",10980,10590,9885,-1095
ISNE,"9/3/2022 11 a.m. EDT",10669,10670,9667,-1002
ISNE,"9/3/2022 12 p.m. EDT",10741,10760,9714,-1027
ISNE,"9/3/2022 1 p.m. EDT",11008,11100,10008,-1000
ISNE,"9/3/2022 2 p.m. EDT",11442,11520,10470,-972
ISNE,"9/3/2022 3 p.m. EDT",11897,12150,10873,-1024
ISNE,"9/3/2022 4 p.m. EDT",12651,12890,11652,-999
ISNE,"9/3/2022 5 p.m. EDT",13408,13720,12348,-1060
ISNE,"9/3/2022 6 p.m. EDT",14316,14550,13244,-1072
ISNE,"9/3/2022 7 p.m. EDT",14720,15000,13703,-1017
ISNE,"9/3/2022 8 p.m. EDT",14607,14710,13476,-1131
ISNE,"9/3/2022 9 p.m. EDT",14227,14210,13277,-950
ISNE,"9/3/2022 10 p.m. EDT",13513,13430,12241,-1272
ISNE,"9/3/2022 11 p.m. EDT",12655,12570,11137,-1518
ISNE,"9/4/2022 12 a.m. EDT",11799,11620,10216,-1583
ISNE,"9/4/2022 1 a.m. EDT",11105,11130,9072,-2033
ISNE,"9/4/2022 2 a.m. EDT",10847,10630,8869,-1978
ISNE,"9/4/2022 3 a.m. EDT",10854,10330,8837,-2017
ISNE,"9/4/2022 4 a.m. EDT",10680,10150,8686,-1994
ISNE,"9/4/2022 5 a.m. EDT",10646,10120,8543,-2103
ISNE,"9/4/2022 6 a.m. EDT",10759,10250,8688,-2071
ISNE,"9/4/2022 7 a.m. EDT",10669,10460,8457,-2212
ISNE,"9/4/2022 8 a.m. EDT",10847,10730,8758,-2089
ISNE,"9/4/2022 9 a.m. EDT",10894,10950,9488,-1406
ISNE,"9/4/2022 10 a.m. EDT",11135,11150,10004,-1131
ISNE,"9/4/2022 11 a.m. EDT",11524,11420,10508,-1016
ISNE,"9/4/2022 12 p.m. EDT",12117,11880,11085,-1032
ISNE,"9/4/2022 1 p.m. EDT",13037,12450,11852,-1185
ISNE,"9/4/2022 2 p.m. EDT",13947,12970,12741,-1206
ISNE,"9/4/2022 3 p.m. EDT",14829,13550,13539,-1290
ISNE,"9/4/2022 4 p.m. EDT",15741,14360,14260,-1481
ISNE,"9/4/2022 5 p.m. EDT",16699,15540,15197,-1502
ISNE,"9/4/2022 6 p.m. EDT",17270,16670,15532,-1738
ISNE,"9/4/2022 7 p.m. EDT",17166,16900,15264,-1902
ISNE,"9/4/2022 8 p.m. EDT",17018,17000,15138,-1880
ISNE,"9/4/2022 9 p.m. EDT",16551,16500,14764,-1787
ISNE,"9/4/2022 10 p.m. EDT",15730,15620,13978,-1752
ISNE,"9/4/2022 11 p.m. EDT",14791,14500,12749,-2042
ISNE,"9/5/2022 12 a.m. EDT",13786,13440,11620,-2166
ISNE,"9/5/2022 1 a.m. EDT",13021,12950,10980,-2041
ISNE,"9/5/2022 2 a.m. EDT",12697,12390,10477,-2220
ISNE,"9/5/2022 3 a.m. EDT",12304,12000,9885,-2419
ISNE,"9/5/2022 4 a.m. EDT",12516,11780,9786,-2730
ISNE,"9/5/2022 5 a.m. EDT",12571,11770,9831,-2740
ISNE,"9/5/2022 6 a.m. EDT",12668,12000,9863,-2805
ISNE,"9/5/2022 7 a.m. EDT",12973,12340,10126,-2847
ISNE,"9/5/2022 8 a.m. EDT",13373,12700,10911,-2462
ISNE,"9/5/2022 9 a.m. EDT",13367,13270,11283,-2084
ISNE,"9/5/2022 10 a.m. EDT",13821,13880,11891,-1930
ISNE,"9/5/2022 11 a.m. EDT",14432,14490,12208,-2224
ISNE,"9/5/2022 12 p.m. EDT",14861,14900,12354,-2507
ISNE,"9/5/2022 1 p.m. EDT",15054,15150,12591,-2463
ISNE,"9/5/2022 2 p.m. EDT",15100,15200,12892,-2208
ISNE,"9/5/2022 3 p.m. EDT",15229,15230,13349,-1880
ISNE,"9/5/2022 4 p.m. EDT",15512,15340,13741,-1771
ISNE,"9/5/2022 5 p.m. EDT",15840,15540,13821,-2019
ISNE,"9/5/2022 6 p.m. EDT",16065,15700,14075,-1990
ISNE,"9/5/2022 7 p.m. EDT",15894,15670,13861,-2033
ISNE,"9/5/2022 8 p.m. EDT",15649,15470,13745,-1904
ISNE,"9/5/2022 9 p.m. EDT",15020,14980,13387,-1633
ISNE,"9/5/2022 10 p.m. EDT",14128,14110,12658,-1470
ISNE,"9/5/2022 11 p.m. EDT",13069,13090,11389,-1680
ISNE,"9/6/2022 12 a.m. EDT",12112,12200,10239,-1873
ISNE,"9/6/2022 1 a.m. EDT",11723,11420,9527,-2196
ISNE,"9/6/2022 2 a.m. EDT",11575,10960,9256,-2319
ISNE,"9/6/2022 3 a.m. EDT",11503,10690,9239,-2264
ISNE,"9/6/2022 4 a.m. EDT",11406,10600,9280,-2126
ISNE,"9/6/2022 5 a.m. EDT",11612,10820,9506,-2106
ISNE,"9/6/2022 6 a.m. EDT",12323,11570,10145,-2178
ISNE,"9/6/2022 7 a.m. EDT",12944,12890,11161,-1783
ISNE,"9/6/2022 8 a.m. EDT",13818,13860,11970,-1848
ISNE,"9/6/2022 9 a.m. EDT",14428,14480,12350,-2078
ISNE,"9/6/2022 10 a.m. EDT",14775,14750,12271,-2504
ISNE,"9/6/2022 11 a.m. EDT",14966,15160,12432,-2534
ISNE,"9/6/2022 12 p.m. EDT",15003,15390,12668,-2335
ISNE,"9/6/2022 1 p.m. EDT",14964,15460,12740,-2224
ISNE,"9/6/2022 2 p.m. EDT",14847,15420,12605,-2242
ISNE,"9/6/2022 3 p.m. EDT",14757,15380,12834,-1923
ISNE,"9/6/2022 4 p.m. EDT",14725,15310,12806,-1919
ISNE,"9/6/2022 5 p.m. EDT",14850,15460,12900,-1950
ISNE,"9/6/2022 6 p.m. EDT",15140,15710,13032,-2108
ISNE,"9/6/2022 7 p.m. EDT",15131,15560,13047,-2084
ISNE,"9/6/2022 8 p.m. EDT",15019,15380,12948,-2071
ISNE,"9/6/2022 9 p.m. EDT",14457,14790,12520,-1937
ISNE,"9/6/2022 10 p.m. EDT",13617,13890,11657,-1960
ISNE,"9/6/2022 11 p.m. EDT",12742,12810,10699,-2043
ISNE,"9/7/2022 12 a.m. EDT",11909,11820,9855,-2054
ISNE,"9/7/2022 1 a.m. EDT",11174,10990,9208,-1966
ISNE,"9/7/2022 2 a.m. EDT",11098,10550,9211,-1887
ISNE,"9/7/2022 3 a.m. EDT",11077,10300,9089,-1988
ISNE,"9/7/2022 4 a.m. EDT",11016,10220,9148,-1868
ISNE,"9/7/2022 5 a.m. EDT",11200,10430,9012,-2188
ISNE,"9/7/2022 6 a.m. EDT",11704,11150,9598,-2106
ISNE,"9/7/2022 7 a.m. EDT",12649,12350,10490,-2159
ISNE,"9/7/2022 8 a.m. EDT",13030,13090,11101,-1929
ISNE,"9/7/2022 9 a.m. EDT",13207,13250,11352,-1855
ISNE,"9/7/2022 10 a.m. EDT",13151,13180,11657,-1494
ISNE,"9/7/2022 11 a.m. EDT",13200,13080,11645,-1555
ISNE,"9/7/2022 12 p.m. EDT",13238,13070,11770,-1468
ISNE,"9/7/2022 1 p.m. EDT",13123,13300,11817,-1306
ISNE,"9/7/2022 2 p.m. EDT",13474,13570,11655,-1819
ISNE,"9/7/2022 3 p.m. EDT",13632,13840,11807,-1825
ISNE,"9/7/2022 4 p.m. EDT",13911,14080,12365,-1546
ISNE,"9/7/2022 5 p.m. EDT",14313,14490,12567,-1746
ISNE,"9/7/2022 6 p.m. EDT",14807,15040,12531,-2276
ISNE,"9/7/2022 7 p.m. EDT",15067,15360,12908,-2159
ISNE,"9/7/2022 8 p.m. EDT",15194,15310,13254,-1940
ISNE,"9/7/2022 9 p.m. EDT",14738,14740,12999,-1739
ISNE,"9/7/2022 10 p.m. EDT",13829,13740,11790,-2039
ISNE,"9/7/2022 11 p.m. EDT",12670,12690,10422,-2248
ISNE,"9/8/2022 12 a.m. EDT",11656,11630,9339,-2317
ISNE,"9/8/2022 1 a.m. EDT",11129,10900,8198,-2931
ISNE,"9/8/2022 2 a.m. EDT",10940,10410,8072,-2868
ISNE,"9/8/2022 3 a.m. EDT",10888,10120,7841,-3047
ISNE,"9/8/2022 4 a.m. EDT",10795,9990,7837,-2958
ISNE,"9/8/2022 5 a.m. EDT",10676,10150,7732,-2944
ISNE,"9/8/2022 6 a.m. EDT",11035,10910,8108,-2927
ISNE,"9/8/2022 7 a.m. EDT",12003,12010,9295,-2708
ISNE,"9/8/2022 8 a.m. EDT",12645,12650,10428,-2217
ISNE,"9/8/2022 9 a.m. EDT",12566,12620,10512,-2054
ISNE,"9/8/2022 10 a.m. EDT",12263,12320,10512,-1751
ISNE,"9/8/2022 11 a.m. EDT",12021,12260,10721,-1300
ISNE,"9/8/2022 12 p.m. EDT",11935,12380,10752,-1183
ISNE,"9/8/2022 1 p.m. EDT",12000,12610,10702,-1298
ISNE,"9/8/2022 2 p.m. EDT",12307,12970,11019,-1288
ISNE,"9/8/2022 3 p.m. EDT",12648,13390,11470,-1178
ISNE,"9/8/2022 4 p.m. EDT",13232,14020,12140,-1092
ISNE,"9/8/2022 5 p.m. EDT",14143,14860,12909,-1234
ISNE,"9/8/2022 6 p.m. EDT",15082,15630,13355,-1727
ISNE,"9/8/2022 7 p.m. EDT",15367,15720,13300,-2067
ISNE,"9/8/2022 8 p.m. EDT",15281,15640,12963,-2318
ISNE,"9/8/2022 9 p.m. EDT",14762,15100,12531,-2231
ISNE,"9/8/2022 10 p.m. EDT",13770,14080,11349,-2421
ISNE,"9/8/2022 11 p.m. EDT",12613,12900,10299,-2314
ISNE,"9/9/2022 12 a.m. EDT",11549,11760,9441,-2108
ISNE,"9/9/2022 1 a.m. EDT",11046,10790,8834,-2212
ISNE,"9/9/2022 2 a.m. EDT",10664,10290,8443,-2221
ISNE,"9/9/2022 3 a.m. EDT",10532,10000,8129,-2403
ISNE,"9/9/2022 4 a.m. EDT",10400,9810,8124,-2276
ISNE,"9/9/2022 5 a.m. EDT",10543,9980,8178,-2365
ISNE,"9/9/2022 6 a.m. EDT",10777,10730,8455,-2322
ISNE,"9/9/2022 7 a.m. EDT",11710,11810,9517,-2193
ISNE,"9/9/2022 8 a.m. EDT",12335,12390,9905,-2430
ISNE,"9/9/2022 9 a.m. EDT",12294,12390,9915,-2379
ISNE,"9/9/2022 10 a.m. EDT",11966,12090,9836,-2130
ISNE,"9/9/2022 11 a.m. EDT",11669,12060,9864,-1805
ISNE,"9/9/2022 12 p.m. EDT",11620,12180,10200,-1420
ISNE,"9/9/2022 1 p.m. EDT",11878,12500,10669,-1209
ISNE,"9/9/2022 2 p.m. EDT",12306,12860,10869,-1437
ISNE,"9/9/2022 3 p.m. EDT",12895,13380,11813,-1082
ISNE,"9/9/2022 4 p.m. EDT",13766,14020,12689,-1077
ISNE,"9/9/2022 5 p.m. EDT",14776,14950,13558,-1218
ISNE,"9/9/2022 6 p.m. EDT",15579,15760,14238,-1341
ISNE,"9/9/2022 7 p.m. EDT",15626,15840,14044,-1582
ISNE,"9/9/2022 8 p.m. EDT",15514,15610,13847,-1667
ISNE,"9/9/2022 9 p.m. EDT",14920,15010,13188,-1732
ISNE,"9/9/2022 10 p.m. EDT",14066,14130,12269,-1797
ISNE,"9/9/2022 11 p.m. EDT",13056,13050,11120,-1936
ISNE,"9/10/2022 12 a.m. EDT",12033,12040,10208,-1825
ISNE,"9/10/2022 1 a.m. EDT",11266,11290,9336,-1930
ISNE,"9/10/2022 2 a.m. EDT",11021,10740,9084,-1937
ISNE,"9/10/2022 3 a.m. EDT",10942,10370,9076,-1866
ISNE,"9/10/2022 4 a.m. EDT",10725,10170,8860,-1865
ISNE,"9/10/2022 5 a.m. EDT",10680,10110,8869,-1811
ISNE,"9/10/2022 6 a.m. EDT",10872,10240,8865,-2007
ISNE,"9/10/2022 7 a.m. EDT",11003,10640,9060,-1943
ISNE,"9/10/2022 8 a.m. EDT",11024,11020,9130,-1894
ISNE,"9/10/2022 9 a.m. EDT",11217,11320,9616,-1601
ISNE,"9/10/2022 10 a.m. EDT",11236,11600,9653,-1583
ISNE,"9/10/2022 11 a.m. EDT",11550,11840,9968,-1582
ISNE,"9/10/2022 12 p.m. EDT",11869,12200,10386,-1483
ISNE,"9/10/2022 1 p.m. EDT",12365,12810,10928,-1437
ISNE,"9/10/2022 2 p.m. EDT",13003,13290,11568,-1435
ISNE,"9/10/2022 3 p.m. EDT",13736,13950,12399,-1337
ISNE,"9/10/2022 4 p.m. EDT",14525,14830,13106,-1419
ISNE,"9/10/2022 5 p.m. EDT",15456,15870,14039,-1417
ISNE,"9/10/2022 6 p.m. EDT",16257,16720,14906,-1351
ISNE,"9/10/2022 7 p.m. EDT",16358,16730,14771,-1587
ISNE,"9/10/2022 8 p.m. EDT",16107,16420,14476,-1631
ISNE,"9/10/2022 9 p.m. EDT",15499,15800,13704,-1795
ISNE,"9/10/2022 10 p.m. EDT",14616,14940,12942,-1674
ISNE,"9/10/2022 11 p.m. EDT",13589,13840,11648,-1941
ISNE,"9/11/2022 12 a.m. EDT",12636,12880,10747,-1889
ISNE,"9/11/2022 1 a.m. EDT",12169,11860,10535,-1634
ISNE,"9/11/2022 2 a.m. EDT",11641,11290,10129,-1512
ISNE,"9/11/2022 3 a.m. EDT",11469,10910,9964,-1505
ISNE,"9/11/2022 4 a.m. EDT",11420,10680,9900,-1520
ISNE,"9/11/2022 5 a.m. EDT",11399,10510,9833,-1566
ISNE,"9/11/2022 6 a.m. EDT",11494,10620,9938,-1556
ISNE,"9/11/2022 7 a.m. EDT",11416,10770,9975,-1441
ISNE,"9/11/2022 8 a.m. EDT",11704,11140,10404,-1300
ISNE,"9/11/2022 9 a.m. EDT",11857,11560,10584,-1273
ISNE,"9/11/2022 10 a.m. EDT",12057,12260,10898,-1159
ISNE,"9/11/2022 11 a.m. EDT",12555,12770,11529,-1026
ISNE,"9/11/2022 12 p.m. EDT",13244,13330,12253,-991
ISNE,"9/11/2022 1 p.m. EDT",13677,13740,12413,-1264
ISNE,"9/11/2022 2 p.m. EDT",13973,14090,12916,-1057
ISNE,"9/11/2022 3 p.m. EDT",14265,14290,13162,-1103
ISNE,"9/11/2022 4 p.m. EDT",14544,14800,13295,-1249
ISNE,"9/11/2022 5 p.m. EDT",14900,15090,13712,-1188
ISNE,"9/11/2022 6 p.m. EDT",15343,15550,14164,-1179
ISNE,"9/11/2022 7 p.m. EDT",15549,15800,14348,-1201
ISNE,"9/11/2022 8 p.m. EDT",15650,15750,14377,-1273
ISNE,"9/11/2022 9 p.m. EDT",15163,15030,13935,-1228
ISNE,"9/11/2022 10 p.m. EDT",14280,14280,13092,-1188
ISNE,"9/11/2022 11 p.m. EDT",13217,13220,11745,-1472
ISNE,"9/12/2022 12 a.m. EDT",12255,12290,10599,-1656
ISNE,"9/12/2022 1 a.m. EDT",11870,11540,10314,-1556
ISNE,"9/12/2022 2 a.m. EDT",11854,11090,10088,-1766
ISNE,"9/12/2022 3 a.m. EDT",11639,10840,10011,-1628
ISNE,"9/12/2022 4 a.m. EDT",11589,10800,10051,-1538
ISNE,"9/12/2022 5 a.m. EDT",11842,11070,10244,-1598
ISNE,"9/12/2022 6 a.m. EDT",12145,11840,10680,-1465
ISNE,"9/12/2022 7 a.m. EDT",13136,13190,11766,-1370
ISNE,"9/12/2022 8 a.m. EDT",13986,14000,12806,-1180
ISNE,"9/12/2022 9 a.m. EDT",14239,14310,13131,-1108
ISNE,"9/12/2022 10 a.m. EDT",14313,14280,13198,-1115
ISNE,"9/12/2022 11 a.m. EDT",14603,14360,13523,-1080
ISNE,"9/12/2022 12 p.m. EDT",14961,14600,13774,-1187
ISNE,"9/12/2022 1 p.m. EDT",14960,15330,13832,-1128
ISNE,"9/12/2022 2 p.m. EDT",15305,15890,14192,-1113
ISNE,"9/12/2022 3 p.m. EDT",15651,16140,14522,-1129
ISNE,"9/12/2022 4 p.m. EDT",16209,16530,15101,-1108
ISNE,"9/12/2022 5 p.m. EDT",16837,17120,15674,-1163
ISNE,"9/12/2022 6 p.m. EDT",17406,17730,16270,-1136
ISNE,"9/12/2022 7 p.m. EDT",17596,17800,16422,-1174
ISNE,"9/12/2022 8 p.m. EDT",17605,17670,16409,-1196
ISNE,"9/12/2022 9 p.m. EDT",17019,16960,15493,-1526
ISNE,"9/12/2022 10 p.m. EDT",15962,15890,14304,-1658
ISNE,"9/12/2022 11 p.m. EDT",14691,14610,13142,-1549
ISNE,"9/13/2022 12 a.m. EDT",13661,13460,11791,-1870
ISNE,"9/13/2022 1 a.m. EDT",12969,12660,11424,-1545
ISNE,"9/13/2022 2 a.m. EDT",12628,12090,11157,-1471
ISNE,"9/13/2022 3 a.m. EDT",12504,11770,11008,-1496
ISNE,"9/13/2022 4 a.m. EDT",12412,11620,10815,-1597
ISNE,"9/13/2022 5 a.m. EDT",12573,11810,10885,-1688
ISNE,"9/13/2022 6 a.m. EDT",12837,12580,11357,-1480
ISNE,"9/13/2022 7 a.m. EDT",13868,13900,12529,-1339
ISNE,"9/13/2022 8 a.m. EDT",14811,14860,13590,-1221
ISNE,"9/13/2022 9 a.m. EDT",15385,15350,13991,-1394
ISNE,"9/13/2022 10 a.m. EDT",15669,15700,14283,-1386
ISNE,"9/13/2022 11 a.m. EDT",15711,15900,14393,-1318
ISNE,"9/13/2022 12 p.m. EDT",15744,16120,14407,-1337
ISNE,"9/13/2022 1 p.m. EDT",15866,16260,14678,-1188
ISNE,"9/13/2022 2 p.m. EDT",,16440,,
ISNE,"9/13/2022 3 p.m. EDT",16218,16580,15105,-1113
ISNE,"9/13/2022 4 p.m. EDT",16569,16800,15013,-1556
ISNE,"9/13/2022 5 p.m. EDT",16960,17150,15509,-1451
ISNE,"9/13/2022 6 p.m. EDT",17408,17790,16423,-985
ISNE,"9/13/2022 7 p.m. EDT",17527,17720,16473,-1054
ISNE,"9/13/2022 8 p.m. EDT",17464,17650,16064,-1400
ISNE,"9/13/2022 9 p.m. EDT",16918,16870,15337,-1581
ISNE,"9/13/2022 10 p.m. EDT",15866,15690,14328,-1538
ISNE,"9/13/2022 11 p.m. EDT",14553,14330,12900,-1653
ISNE,"9/14/2022 12 a.m. EDT",13245,13130,11487,-1758
ISNE,"9/14/2022 1 a.m. EDT",12470,12290,10706,-1764
ISNE,"9/14/2022 2 a.m. EDT",11903,11600,10077,-1826
ISNE,"9/14/2022 3 a.m. EDT",11649,11100,9897,-1752
ISNE,"9/14/2022 4 a.m. EDT",11358,10800,9626,-1732
ISNE,"9/14/2022 5 a.m. EDT",11390,10850,9692,-1698
ISNE,"9/14/2022 6 a.m. EDT",11965,11470,10254,-1711
ISNE,"9/14/2022 7 a.m. EDT",12571,12600,11131,-1440
ISNE,"9/14/2022 8 a.m. EDT",13110,13170,11668,-1442
ISNE,"9/14/2022 9 a.m. EDT",12883,12900,11437,-1446
ISNE,"9/14/2022 10 a.m. EDT",12546,12410,11292,-1254
ISNE,"9/14/2022 11 a.m. EDT",12468,12260,11471,-997
ISNE,"9/14/2022 12 p.m. EDT",12652,12410,11614,-1038
ISNE,"9/14/2022 1 p.m. EDT",13035,12870,12204,-831
ISNE,"9/14/2022 2 p.m. EDT",13615,13510,12786,-829
ISNE,"9/14/2022 3 p.m. EDT",14060,14100,13187,-873
ISNE,"9/14/2022 4 p.m. EDT",14531,14780,13695,-836
ISNE,"9/14/2022 5 p.m. EDT",15410,15870,14656,-754
ISNE,"9/14/2022 6 p.m. EDT",16211,16660,15098,-1113
ISNE,"9/14/2022 7 p.m. EDT",16359,16700,15068,-1291
ISNE,"9/14/2022 8 p.m. EDT",16328,16490,14975,-1353
ISNE,"9/14/2022 9 p.m. EDT",15658,15810,14185,-1473
ISNE,"9/14/2022 10 p.m. EDT",14598,14750,13206,-1392
ISNE,"9/14/2022 11 p.m. EDT",13340,13540,11624,-1716
ISNE,"9/15/2022 12 a.m. EDT",12231,12390,10576,-1655
ISNE,"9/15/2022 1 a.m. EDT",11739,11450,10363,-1376
ISNE,"9/15/2022 2 a.m. EDT",11229,10920,9849,-1380
ISNE,"9/15/2022 3 a.m. EDT",11001,10600,9450,-1551
ISNE,"9/15/2022 4 a.m. EDT",10995,10440,9519,-1476
ISNE,"9/15/2022 5 a.m. EDT",10825,10540,9388,-1437
ISNE,"9/15/2022 6 a.m. EDT",11404,11130,10014,-1390
ISNE,"9/15/2022 7 a.m. EDT",12116,12170,10721,-1395
ISNE,"9/15/2022 8 a.m. EDT",12513,12540,10987,-1526
ISNE,"9/15/2022 9 a.m. EDT",12131,12050,10697,-1434
ISNE,"9/15/2022 10 a.m. EDT",11534,11300,10325,-1209
ISNE,"9/15/2022 11 a.m. EDT",11064,10830,9988,-1076
ISNE,"9/15/2022 12 p.m. EDT",10879,10680,9907,-972
ISNE,"9/15/2022 1 p.m. EDT",10858,10730,9986,-872
ISNE,"9/15/2022 2 p.m. EDT",11048,11030,10090,-958
ISNE,"9/15/2022 3 p.m. EDT",11337,11490,10407,-930
ISNE,"9/15/2022 4 p.m. EDT",11877,12070,10984,-893
ISNE,"9/15/2022 5 p.m. EDT",12730,13040,12111,-619
ISNE,"9/15/2022 6 p.m. EDT",13800,13930,13056,-744
ISNE,"9/15/2022 7 p.m. EDT",14246,14400,13327,-919
ISNE,"9/15/2022 8 p.m. EDT",14288,14290,13074,-1214
ISNE,"9/15/2022 9 p.m. EDT",13734,13770,12224,-1510
ISNE,"9/15/2022 10 p.m. EDT",12835,12930,11365,-1470
ISNE,"9/15/2022 11 p.m. EDT",11697,11900,9945,-1752
ISNE,"9/16/2022 12 a.m. EDT",10888,10940,9222,-1666
ISNE,"9/16/2022 1 a.m. EDT",10186,10080,8487,-1699
ISNE,"9/16/2022 2 a.m. EDT",9950,9660,8264,-1686
ISNE,"9/16/2022 3 a.m. EDT",9977,9440,8179,-1798
ISNE,"9/16/2022 4 a.m. EDT",9917,9380,8070,-1847
ISNE,"9/16/2022 5 a.m. EDT",10096,9580,8227,-1869
ISNE,"9/16/2022 6 a.m. EDT",10509,10240,8558,-1951
ISNE,"9/16/2022 7 a.m. EDT",11351,11400,9904,-1447
ISNE,"9/16/2022 8 a.m. EDT",11906,11930,10468,-1438
ISNE,"9/16/2022 9 a.m. EDT",11700,11720,10506,-1194
ISNE,"9/16/2022 10 a.m. EDT",11239,11110,10126,-1113
ISNE,"9/16/2022 11 a.m. EDT",10951,10770,9784,-1167
ISNE,"9/16/2022 12 p.m. EDT",10740,10570,9575,-1165
ISNE,"9/16/2022 1 p.m. EDT",10725,10500,9532,-1193
ISNE,"9/16/2022 2 p.m. EDT",10811,10550,9613,-1198
ISNE,"9/16/2022 3 p.m. EDT",10867,10950,9642,-1225
ISNE,"9/16/2022 4 p.m. EDT",11426,11510,10262,-1164
ISNE,"9/16/2022 5 p.m. EDT",12266,12330,11060,-1206
ISNE,"9/16/2022 6 p.m. EDT",13242,13250,12014,-1228
ISNE,"9/16/2022 7 p.m. EDT",13673,13650,12403,-1270
ISNE,"9/16/2022 8 p.m. EDT",13730,13800,12430,-1300
ISNE,"9/16/2022 9 p.m. EDT",13204,13180,11853,-1351
ISNE,"9/16/2022 10 p.m. EDT",12496,12460,11102,-1394
ISNE,"9/16/2022 11 p.m. EDT",11577,11550,10077,-1500
ISNE,"9/17/2022 12 a.m. EDT",10681,10630,9086,-1595
ISNE,"9/17/2022 1 a.m. EDT",10037,10060,8357,-1680
ISNE,"9/17/2022 2 a.m. EDT",9639,9620,8002,-1637
ISNE,"9/17/2022 3 a.m. EDT",9868,9350,8214,-1654
ISNE,"9/17/2022 4 a.m. EDT",9773,9240,8120,-1653
ISNE,"9/17/2022 5 a.m. EDT",9527,9250,7908,-1619
ISNE,"9/17/2022 6 a.m. EDT",9642,9510,7961,-1681
ISNE,"9/17/2022 7 a.m. EDT",9914,9970,8340,-1574
ISNE,"9/17/2022 8 a.m. EDT",10208,10240,8774,-1434
ISNE,"9/17/2022 9 a.m. EDT",10007,10030,8675,-1332
ISNE,"9/17/2022 10 a.m. EDT",9716,9650,8631,-1085
ISNE,"9/17/2022 11 a.m. EDT",9356,9430,8252,-1104
ISNE,"9/17/2022 12 p.m. EDT",9334,9300,8247,-1087
ISNE,"9/17/2022 1 p.m. EDT",9460,9290,8264,-1196
ISNE,"9/17/2022 2 p.m. EDT",9569,9380,8356,-1213
ISNE,"9/17/2022 3 p.m. EDT",9836,9710,8637,-1199
ISNE,"9/17/2022 4 p.m. EDT",10066,10340,9037,-1029
ISNE,"9/17/2022 5 p.m. EDT",11064,11310,9969,-1095
ISNE,"9/17/2022 6 p.m. EDT",12210,12360,11004,-1206
ISNE,"9/17/2022 7 p.m. EDT",12804,12940,11652,-1152
ISNE,"9/17/2022 8 p.m. EDT",13001,13150,11834,-1167
ISNE,"9/17/2022 9 p.m. EDT",12590,12590,11279,-1311
ISNE,"9/17/2022 10 p.m. EDT",11999,11990,10621,-1378
ISNE,"9/17/2022 11 p.m. EDT",11278,11230,9823,-1455
ISNE,"9/18/2022 12 a.m. EDT",10554,10590,8994,-1560
ISNE,"9/18/2022 1 a.m. EDT",9973,10000,8624,-1349
ISNE,"9/18/2022 2 a.m. EDT",9613,9640,8384,-1229
ISNE,"9/18/2022 3 a.m. EDT",9369,9390,8358,-1011
ISNE,"9/18/2022 4 a.m. EDT",9258,9290,8141,-1117
ISNE,"9/18/2022 5 a.m. EDT",9303,9340,8382,-921
ISNE,"9/18/2022 6 a.m. EDT",9495,9550,8290,-1205
ISNE,"9/18/2022 7 a.m. EDT",9845,9900,8626,-1219
ISNE,"9/18/2022 8 a.m. EDT",10156,10200,8979,-1177
ISNE,"9/18/2022 9 a.m. EDT",10395,10430,9426,-969
ISNE,"9/18/2022 10 a.m. EDT",10353,10360,9423,-930
ISNE,"9/18/2022 11 a.m. EDT",10366,10510,9503,-863
ISNE,"9/18/2022 12 p.m. EDT",10652,11140,9890,-762
ISNE,"9/18/2022 1 p.m. EDT",11173,11640,10318,-855
ISNE,"9/18/2022 2 p.m. EDT",11862,12140,11033,-829
ISNE,"9/18/2022 3 p.m. EDT",12721,12760,11903,-818
ISNE,"9/18/2022 4 p.m. EDT",13690,13600,12811,-879
ISNE,"9/18/2022 5 p.m. EDT",14716,14520,13825,-891
ISNE,"9/18/2022 6 p.m. EDT",15633,15370,14777,-856
ISNE,"9/18/2022 7 p.m. EDT",15956,15640,15120,-836
ISNE,"9/18/2022 8 p.m. EDT",16028,15600,15135,-893
ISNE,"9/18/2022 9 p.m. EDT",15454,14960,14442,-1012
ISNE,"9/18/2022 10 p.m. EDT",14498,14080,13460,-1038
ISNE,"9/18/2022 11 p.m. EDT",13384,13040,12208,-1176
ISNE,"9/19/2022 12 a.m. EDT",12659,12060,11271,-1388
ISNE,"9/19/2022 1 a.m. EDT",12009,11610,10615,-1394
ISNE,"9/19/2022 2 a.m. EDT",11648,11080,10152,-1496
ISNE,"9/19/2022 3 a.m. EDT",11540,10760,10049,-1491
ISNE,"9/19/2022 4 a.m. EDT",11645,10650,10148,-1497
ISNE,"9/19/2022 5 a.m. EDT",11795,10670,10652,-1143
ISNE,"9/19/2022 6 a.m. EDT",11557,11350,11250,-307
ISNE,"9/19/2022 7 a.m. EDT",13057,12600,13107,50
ISNE,"9/19/2022 8 a.m. EDT",13857,13390,14183,326
ISNE,"9/19/2022 9 a.m. EDT",13803,13680,14252,449
ISNE,"9/19/2022 10 a.m. EDT",14129,13820,14653,524
ISNE,"9/19/2022 11 a.m. EDT",13959,13960,14585,626
ISNE,"9/19/2022 12 p.m. EDT",14016,14160,14665,649
ISNE,"9/19/2022 1 p.m. EDT",14348,14410,15001,653
ISNE,"9/19/2022 2 p.m. EDT",14530,14780,15158,628
ISNE,"9/19/2022 3 p.m. EDT",14699,14930,15320,621
ISNE,"9/19/2022 4 p.m. EDT",15106,15120,15657,551
ISNE,"9/19/2022 5 p.m. EDT",15507,15490,16159,652
ISNE,"9/19/2022 6 p.m. EDT",15961,15930,16638,677
ISNE,"9/19/2022 7 p.m. EDT",16022,15950,16558,536
ISNE,"9/19/2022 8 p.m. EDT",15691,15870,16287,596
ISNE,"9/19/2022 9 p.m. EDT",14946,15200,15497,551
ISNE,"9/19/2022 10 p.m. EDT",13956,14230,14321,365
ISNE,"9/19/2022 11 p.m. EDT",12786,13110,13147,361
ISNE,"9/20/2022 12 a.m. EDT",12035,12060,12129,94
ISNE,"9/20/2022 1 a.m. EDT",11591,11230,11324,-267
ISNE,"9/20/2022 2 a.m. EDT",11478,10740,10904,-574
ISNE,"9/20/2022 3 a.m. EDT",11284,10440,10693,-591
ISNE,"9/20/2022 4 a.m. EDT",11168,10100,10538,-630
ISNE,"9/20/2022 5 a.m. EDT",11332,10210,10788,-544
ISNE,"9/20/2022 6 a.m. EDT",11665,10920,11172,-493
ISNE,"9/20/2022 7 a.m. EDT",12526,12500,12348,-178
ISNE,"9/20/2022 8 a.m. EDT",13265,13270,13110,-155
ISNE,"9/20/2022 9 a.m. EDT",13440,13520,13568,128
ISNE,"9/20/2022 10 a.m. EDT",13319,13400,13639,320
ISNE,"9/20/2022 11 a.m. EDT",13386,13470,13857,471
ISNE,"9/20/2022 12 p.m. EDT",13407,13610,13932,525
ISNE,"9/20/2022 1 p.m. EDT",13452,13600,14031,579
ISNE,"9/20/2022 2 p.m. EDT",13690,13610,14218,528
ISNE,"9/20/2022 3 p.m. EDT",13706,13700,14217,511
ISNE,"9/20/2022 4 p.m. EDT",13908,13900,14405,497
ISNE,"9/20/2022 5 p.m. EDT",14338,14330,14905,567
ISNE,"9/20/2022 6 p.m. EDT",14820,14990,15342,522
ISNE,"9/20/2022 7 p.m. EDT",15041,15250,15505,464
ISNE,"9/20/2022 8 p.m. EDT",14998,15100,15525,527
ISNE,"9/20/2022 9 p.m. EDT",14296,14500,14719,423
ISNE,"9/20/2022 10 p.m. EDT",13347,13400,13642,295
ISNE,"9/20/2022 11 p.m. EDT",12236,12290,12240,4
ISNE,"9/21/2022 12 a.m. EDT",11468,11280,11130,-338
ISNE,"9/21/2022 1 a.m. EDT",10770,10640,10172,-598
ISNE,"9/21/2022 2 a.m. EDT",10604,10170,9742,-862
ISNE,"9/21/2022 3 a.m. EDT",10355,9900,9533,-822
ISNE,"9/21/2022 4 a.m. EDT",10265,9720,9508,-757
ISNE,"9/21/2022 5 a.m. EDT",10464,9930,9628,-836
ISNE,"9/21/2022 6 a.m. EDT",10674,10620,9986,-688
ISNE,"9/21/2022 7 a.m. EDT",11927,11920,11485,-442
ISNE,"9/21/2022 8 a.m. EDT",12632,12610,12399,-233
ISNE,"9/21/2022 9 a.m. EDT",12531,12670,12499,-32
ISNE,"9/21/2022 10 a.m. EDT",12335,12390,12550,215
ISNE,"9/21/2022 11 a.m. EDT",12601,12310,12960,359
ISNE,"9/21/2022 12 p.m. EDT",12626,12310,13104,478
ISNE,"9/21/2022 1 p.m. EDT",12518,12480,13022,504
ISNE,"9/21/2022 2 p.m. EDT",12361,12820,12824,463
ISNE,"9/21/2022 3 p.m. EDT",12210,13100,12740,530
ISNE,"9/21/2022 4 p.m. EDT",12609,13650,13133,524
ISNE,"9/21/2022 5 p.m. EDT",13387,14210,13853,466
ISNE,"9/21/2022 6 p.m. EDT",14422,15060,14963,541
ISNE,"9/21/2022 7 p.m. EDT",14815,15350,15376,561
ISNE,"9/21/2022 8 p.m. EDT",14912,15340,15458,546
ISNE,"9/21/2022 9 p.m. EDT",14278,14750,14756,478
ISNE,"9/21/2022 10 p.m. EDT",13353,13800,13702,349
ISNE,"9/21/2022 11 p.m. EDT",12282,12710,12436,154
ISNE,"9/22/2022 12 a.m. EDT",11304,11700,11342,38
ISNE,"9/22/2022 1 a.m. EDT",10962,10640,10817,-145
ISNE,"9/22/2022 2 a.m. EDT",10818,10260,10640,-178
ISNE,"9/22/2022 3 a.m. EDT",10646,10070,9996,-650
ISNE,"9/22/2022 4 a.m. EDT",10401,10040,9897,-504
ISNE,"9/22/2022 5 a.m. EDT",10850,10340,10504,-346
ISNE,"9/22/2022 6 a.m. EDT",11483,11140,11340,-143
ISNE,"9/22/2022 7 a.m. EDT",12530,12560,12529,-1
ISNE,"9/22/2022 8 a.m. EDT",13609,13630,13659,50
ISNE,"9/22/2022 9 a.m. EDT",14372,14370,14455,83
ISNE,"9/22/2022 10 a.m. EDT",14792,14790,14877,85
ISNE,"9/22/2022 11 a.m. EDT",14948,14950,14889,-59
ISNE,"9/22/2022 12 p.m. EDT",14982,14980,15095,113
ISNE,"9/22/2022 1 p.m. EDT",14944,14940,14867,-77
ISNE,"9/22/2022 2 p.m. EDT",14750,14730,14589,-161
ISNE,"9/22/2022 3 p.m. EDT",14196,14190,14025,-171
ISNE,"9/22/2022 4 p.m. EDT",13614,13530,13329,-285
ISNE,"9/22/2022 5 p.m. EDT",13448,13760,13311,-137
ISNE,"9/22/2022 6 p.m. EDT",13876,14010,13807,-69
ISNE,"9/22/2022 7 p.m. EDT",14165,14290,14183,18
ISNE,"9/22/2022 8 p.m. EDT",14211,14360,14157,-54
ISNE,"9/22/2022 9 p.m. EDT",13607,13730,13471,-136
ISNE,"9/22/2022 10 p.m. EDT",12705,12840,12550,-155
ISNE,"9/22/2022 11 p.m. EDT",11777,11780,11487,-290
ISNE,"9/23/2022 12 a.m. EDT",10941,10760,10458,-483
ISNE,"9/23/2022 1 a.m. EDT",10606,10000,9919,-687
ISNE,"9/23/2022 2 a.m. EDT",10274,9570,9493,-781
ISNE,"9/23/2022 3 a.m. EDT",10179,9320,9474,-705
ISNE,"9/23/2022 4 a.m. EDT",10086,9250,9382,-704
ISNE,"9/23/2022 5 a.m. EDT",10197,9460,9493,-704
ISNE,"9/23/2022 6 a.m. EDT",10516,10160,9877,-639
ISNE,"9/23/2022 7 a.m. EDT",11388,11390,10872,-516
ISNE,"9/23/2022 8 a.m. EDT",11968,11980,11472,-496
ISNE,"9/23/2022 9 a.m. EDT",11700,11670,11317,-383
ISNE,"9/23/2022 10 a.m. EDT",11298,11030,11054,-244
ISNE,"9/23/2022 11 a.m. EDT",10725,10460,10786,61
ISNE,"9/23/2022 12 p.m. EDT",10369,10110,10527,158
ISNE,"9/23/2022 1 p.m. EDT",10133,9830,10268,135
ISNE,"9/23/2022 2 p.m. EDT",10075,9910,10141,66
ISNE,"9/23/2022 3 p.m. EDT",10124,10120,10180,56
ISNE,"9/23/2022 4 p.m. EDT",10538,10610,10853,315
ISNE,"9/23/2022 5 p.m. EDT",11160,11570,11378,218
ISNE,"9/23/2022 6 p.m. EDT",12264,12720,12402,138
ISNE,"9/23/2022 7 p.m. EDT",12925,13380,13088,163
ISNE,"9/23/2022 8 p.m. EDT",13141,13520,13193,52
ISNE,"9/23/2022 9 p.m. EDT",12671,13000,12627,-44
ISNE,"9/23/2022 10 p.m. EDT",12036,12320,11928,-108
ISNE,"9/23/2022 11 p.m. EDT",11197,11450,11018,-179
ISNE,"9/24/2022 12 a.m. EDT",10349,10580,10270,-79
ISNE,"9/24/2022 1 a.m. EDT",9727,9720,9736,9
ISNE,"9/24/2022 2 a.m. EDT",9315,9310,9138,-177
ISNE,"9/24/2022 3 a.m. EDT",9081,9090,8828,-253
ISNE,"9/24/2022 4 a.m. EDT",9235,9010,8972,-263
ISNE,"9/24/2022 5 a.m. EDT",9151,9100,8944,-207
ISNE,"9/24/2022 6 a.m. EDT",9394,9410,9209,-185
ISNE,"9/24/2022 7 a.m. EDT",9952,9980,9760,-192
ISNE,"9/24/2022 8 a.m. EDT",10345,10390,10225,-120
ISNE,"9/24/2022 9 a.m. EDT",10041,10130,10107,66
ISNE,"9/24/2022 10 a.m. EDT",9524,9360,9758,234
ISNE,"9/24/2022 11 a.m. EDT",9383,8920,9475,92
ISNE,"9/24/2022 12 p.m. EDT",9088,8720,9191,103
ISNE,"9/24/2022 1 p.m. EDT",8894,8650,8995,101
ISNE,"9/24/2022 2 p.m. EDT",9050,8770,9109,59
ISNE,"9/24/2022 3 p.m. EDT",9275,9040,9366,91
ISNE,"9/24/2022 4 p.m. EDT",9385,9740,9481,96
ISNE,"9/24/2022 5 p.m. EDT",10422,10700,10554,132
ISNE,"9/24/2022 6 p.m. EDT",11656,12080,11603,-53
ISNE,"9/24/2022 7 p.m. EDT",12402,12620,12372,-30
ISNE,"9/24/2022 8 p.m. EDT",12558,12760,12546,-12
ISNE,"9/24/2022 9 p.m. EDT",12113,12260,11988,-125
ISNE,"9/24/2022 10 p.m. EDT",11492,11610,11355,-137
ISNE,"9/24/2022 11 p.m. EDT",10772,10870,10515,-257
ISNE,"9/25/2022 12 a.m. EDT",10027,10150,10028,1
ISNE,"9/25/2022 1 a.m. EDT",9447,9690,9329,-118
ISNE,"9/25/2022 2 a.m. EDT",9083,9280,8999,-84
ISNE,"9/25/2022 3 a.m. EDT",8874,9030,8789,-85
ISNE,"9/25/2022 4 a.m. EDT",8768,8910,8702,-66
ISNE,"9/25/2022 5 a.m. EDT",8813,8920,8597,-216
ISNE,"9/25/2022 6 a.m. EDT",9010,9050,8743,-267
ISNE,"9/25/2022 7 a.m. EDT",9397,9370,9267,-130
ISNE,"9/25/2022 8 a.m. EDT",9684,9670,9615,-69
ISNE,"9/25/2022 9 a.m. EDT",9971,10060,9904,-67
ISNE,"9/25/2022 10 a.m. EDT",10115,10210,10157,42
ISNE,"9/25/2022 11 a.m. EDT",10286,10340,10287,1
ISNE,"9/25/2022 12 p.m. EDT",10405,10520,10414,9
ISNE,"9/25/2022 1 p.m. EDT",10731,10770,10813,82
ISNE,"9/25/2022 2 p.m. EDT",10992,10960,11111,119
ISNE,"9/25/2022 3 p.m. EDT",11328,11210,11320,-8
ISNE,"9/25/2022 4 p.m. EDT",11805,11600,11851,46
ISNE,"9/25/2022 5 p.m. EDT",12272,12340,12253,-19
ISNE,"9/25/2022 6 p.m. EDT",12995,13070,13038,43
ISNE,"9/25/2022 7 p.m. EDT",13391,13480,13250,-141
ISNE,"9/25/2022 8 p.m. EDT",13411,13540,13341,-70
ISNE,"9/25/2022 9 p.m. EDT",12871,12940,12994,123
ISNE,"9/25/2022 10 p.m. EDT",12066,12130,11972,-94
ISNE,"9/25/2022 11 p.m. EDT",11149,11300,10948,-201
ISNE,"9/26/2022 12 a.m. EDT",10340,10550,10268,-72
ISNE,"9/26/2022 1 a.m. EDT",9771,9930,9484,-287
ISNE,"9/26/2022 2 a.m. EDT",9501,9550,9072,-429
ISNE,"9/26/2022 3 a.m. EDT",9582,9380,9217,-365
ISNE,"9/26/2022 4 a.m. EDT",9563,9310,9157,-406
ISNE,"9/26/2022 5 a.m. EDT",9812,9600,9239,-573
ISNE,"9/26/2022 6 a.m. EDT",10548,10370,9862,-686
ISNE,"9/26/2022 7 a.m. EDT",11497,11720,11347,-150
ISNE,"9/26/2022 8 a.m. EDT",12248,12480,12128,-120
ISNE,"9/26/2022 9 a.m. EDT",12272,12590,12170,-102
ISNE,"9/26/2022 10 a.m. EDT",12004,12070,11952,-52
ISNE,"9/26/2022 11 a.m. EDT",11624,11750,11711,87
ISNE,"9/26/2022 12 p.m. EDT",11309,11670,11459,150
ISNE,"9/26/2022 1 p.m. EDT",11392,11720,11461,69
ISNE,"9/26/2022 2 p.m. EDT",11615,11900,11770,155
ISNE,"9/26/2022 3 p.m. EDT",11842,12170,11899,57
ISNE,"9/26/2022 4 p.m. EDT",12227,12820,12374,147
ISNE,"9/26/2022 5 p.m. EDT",13116,13570,13182,66
ISNE,"9/26/2022 6 p.m. EDT",14098,14490,14059,-39
ISNE,"9/26/2022 7 p.m. EDT",14542,14780,14383,-159
ISNE,"9/26/2022 8 p.m. EDT",14519,14720,14415,-104
ISNE,"9/26/2022 9 p.m. EDT",13793,14040,13647,-146
ISNE,"9/26/2022 10 p.m. EDT",12893,13060,12683,-210
ISNE,"9/26/2022 11 p.m. EDT",12051,11930,11629,-422
ISNE,"9/27/2022 12 a.m. EDT",11068,10910,10940,-128
ISNE,"9/27/2022 1 a.m. EDT",10409,10110,10291,-118
ISNE,"9/27/2022 2 a.m. EDT",10089,9720,9942,-147
ISNE,"9/27/2022 3 a.m. EDT",10081,9450,9774,-307
ISNE,"9/27/2022 4 a.m. EDT",10015,9390,9723,-292
ISNE,"9/27/2022 5 a.m. EDT",10161,9610,9843,-318
ISNE,"9/27/2022 6 a.m. EDT",10705,10360,10414,-291
ISNE,"9/27/2022 7 a.m. EDT",11744,11670,11769,25
ISNE,"9/27/2022 8 a.m. EDT",12475,12430,12208,-267
ISNE,"9/27/2022 9 a.m. EDT",12534,12460,12175,-359
ISNE,"9/27/2022 10 a.m. EDT",12118,12100,11939,-179
ISNE,"9/27/2022 11 a.m. EDT",11420,11200,11285,-135
ISNE,"9/27/2022 12 p.m. EDT",11137,11060,11153,16
ISNE,"9/27/2022 1 p.m. EDT",10980,11040,11090,110
ISNE,"9/27/2022 2 p.m. EDT",11219,11140,11410,191
ISNE,"9/27/2022 3 p.m. EDT",11567,11360,11763,196
ISNE,"9/27/2022 4 p.m. EDT",12020,11970,12273,253
ISNE,"9/27/2022 5 p.m. EDT",12679,12950,12913,234
ISNE,"9/27/2022 6 p.m. EDT",13691,13820,13661,-30
ISNE,"9/27/2022 7 p.m. EDT",14161,14170,13965,-196
ISNE,"9/27/2022 8 p.m. EDT",14171,14190,13941,-230
ISNE,"9/27/2022 9 p.m. EDT",13475,13530,13306,-169
ISNE,"9/27/2022 10 p.m. EDT",12533,12700,12630,97
ISNE,"9/27/2022 11 p.m. EDT",11664,11580,11853,189
ISNE,"9/28/2022 12 a.m. EDT",10724,10620,10812,88
ISNE,"9/28/2022 1 a.m. EDT",9908,9990,9978,70
ISNE,"9/28/2022 2 a.m. EDT",9694,9570,9524,-170
ISNE,"9/28/2022 3 a.m. EDT",9579,9360,9486,-93
ISNE,"9/28/2022 4 a.m. EDT",9527,9300,9439,-88
ISNE,"9/28/2022 5 a.m. EDT",9765,9530,9565,-200
ISNE,"9/28/2022 6 a.m. EDT",10408,10250,10071,-337
ISNE,"9/28/2022 7 a.m. EDT",11549,11480,11131,-418
ISNE,"9/28/2022 8 a.m. EDT",12200,12160,11693,-507
ISNE,"9/28/2022 9 a.m. EDT",11822,12010,11232,-590
ISNE,"9/28/2022 10 a.m. EDT",11190,11280,10902,-288
ISNE,"9/28/2022 11 a.m. EDT",10839,11050,11024,185
ISNE,"9/28/2022 12 p.m. EDT",10913,10990,11163,250
ISNE,"9/28/2022 1 p.m. EDT",11136,11020,11389,253
ISNE,"9/28/2022 2 p.m. EDT",11397,11290,11587,190
ISNE,"9/28/2022 3 p.m. EDT",11542,11640,11656,114
ISNE,"9/28/2022 4 p.m. EDT",11846,12190,11978,132
ISNE,"9/28/2022 5 p.m. EDT",12549,12840,12542,-7
ISNE,"9/28/2022 6 p.m. EDT",13537,13730,13364,-173
ISNE,"9/28/2022 7 p.m. EDT",14092,14160,13856,-236
ISNE,"9/28/2022 8 p.m. EDT",14154,14110,13943,-211
ISNE,"9/28/2022 9 p.m. EDT",13507,13490,13273,-234
ISNE,"9/28/2022 10 p.m. EDT",12594,12610,12490,-104
ISNE,"9/28/2022 11 p.m. EDT",11530,11550,11609,79
ISNE,"9/29/2022 12 a.m. EDT",10813,10580,10963,150
ISNE,"9/29/2022 1 a.m. EDT",10403,9910,10419,16
ISNE,"9/29/2022 2 a.m. EDT",10064,9490,9964,-100
ISNE,"9/29/2022 3 a.m. EDT",9838,9260,9762,-76
ISNE,"9/29/2022 4 a.m. EDT",10011,9190,9972,-39
ISNE,"9/29/2022 5 a.m. EDT",10260,9440,10157,-103
ISNE,"9/29/2022 6 a.m. EDT",10504,10210,10667,163
ISNE,"9/29/2022 7 a.m. EDT",11692,11580,11513,-179
ISNE,"9/29/2022 8 a.m. EDT",12199,12200,12070,-129
ISNE,"9/29/2022 9 a.m. EDT",11767,11750,11891,124
ISNE,"9/29/2022 10 a.m. EDT",11117,11100,11271,154
ISNE,"9/29/2022 11 a.m. EDT",10939,10710,11015,76
ISNE,"9/29/2022 12 p.m. EDT",10789,10620,10898,109
ISNE,"9/29/2022 1 p.m. EDT",10659,10530,10772,113
ISNE,"9/29/2022 2 p.m. EDT",10705,10650,10800,95
ISNE,"9/29/2022 3 p.m. EDT",10662,10860,10692,30
ISNE,"9/29/2022 4 p.m. EDT",11021,11500,11071,50
ISNE,"9/29/2022 5 p.m. EDT",11959,12500,11967,8
ISNE,"9/29/2022 6 p.m. EDT",13016,13430,12838,-178
ISNE,"9/29/2022 7 p.m. EDT",13665,13910,13427,-238
ISNE,"9/29/2022 8 p.m. EDT",13764,14000,13472,-292
ISNE,"9/29/2022 9 p.m. EDT",13185,13320,12836,-349
ISNE,"9/29/2022 10 p.m. EDT",12332,12490,12054,-278
ISNE,"9/29/2022 11 p.m. EDT",11317,11450,11116,-201
ISNE,"9/30/2022 12 a.m. EDT",10386,10490,10489,103
ISNE,"9/30/2022 1 a.m. EDT",9802,9770,9968,166
ISNE,"9/30/2022 2 a.m. EDT",9710,9380,9798,88
ISNE,"9/30/2022 3 a.m. EDT",9515,9200,9609,94
ISNE,"9/30/2022 4 a.m. EDT",9492,9170,9580,88
ISNE,"9/30/2022 5 a.m. EDT",9746,9450,9830,84
ISNE,"9/30/2022 6 a.m. EDT",10183,10210,10232,49
ISNE,"9/30/2022 7 a.m. EDT",11520,11550,11428,-92
ISNE,"9/30/2022 8 a.m. EDT",12204,12200,12193,-11
ISNE,"9/30/2022 9 a.m. EDT",11879,11860,11926,47
ISNE,"9/30/2022 10 a.m. EDT",11144,11020,11450,306
ISNE,"9/30/2022 11 a.m. EDT",10806,10870,11080,274
ISNE,"9/30/2022 12 p.m. EDT",10538,10790,10815,277
ISNE,"9/30/2022 1 p.m. EDT",10506,10810,10747,241
ISNE,"9/30/2022 2 p.m. EDT",10535,10880,10786,251
ISNE,"9/30/2022 3 p.m. EDT",10629,11170,10881,252
ISNE,"9/30/2022 4 p.m. EDT",11089,11600,11326,237
ISNE,"9/30/2022 5 p.m. EDT",11893,12290,11840,-53
ISNE,"9/30/2022 6 p.m. EDT",12733,13270,12492,-241
ISNE,"9/30/2022 7 p.m. EDT",13287,13750,13042,-245
ISNE,"9/30/2022 8 p.m. EDT",13275,13590,13006,-269
ISNE,"9/30/2022 9 p.m. EDT",12743,12890,12317,-426
ISNE,"9/30/2022 10 p.m. EDT",12046,12140,11849,-197
ISNE,"9/30/2022 11 p.m. EDT",11171,11250,10612,-559
ISNE,"10/1/2022 12 a.m. EDT",10345,10440,10050,-295
