"BA Code","Timestamp (Hour Ending)","Demand (MWh)","Demand Forecast (MWh)","Net Generation (MWh)","Total Interchange (MWh)"
ISNE,"11/1/2022 12 a.m. EDT",10322,10470,8082,-2240
ISNE,"11/1/2022 1 a.m. EDT",10243,9830,8103,-2140
ISNE,"11/1/2022 2 a.m. EDT",10134,9490,8092,-2042
ISNE,"11/1/2022 3 a.m. EDT",10247,9280,8108,-2139
ISNE,"11/1/2022 4 a.m. EDT",10240,9280,8262,-1978
ISNE,"11/1/2022 5 a.m. EDT",10163,9560,8102,-2061
ISNE,"11/1/2022 6 a.m. EDT",10707,10370,8243,-2464
ISNE,"11/1/2022 7 a.m. EDT",11595,11770,9073,-2522
ISNE,"11/1/2022 8 a.m. EDT",12705,13060,9927,-2778
ISNE,"11/1/2022 9 a.m. EDT",13049,13200,10520,-2529
ISNE,"11/1/2022 10 a.m. EDT",13184,12840,10640,-2544
ISNE,"11/1/2022 11 a.m. EDT",13251,13220,10451,-2800
ISNE,"11/1/2022 12 p.m. EDT",13229,13180,10283,-2946
ISNE,"11/1/2022 1 p.m. EDT",13125,13220,10281,-2844
ISNE,"11/1/2022 2 p.m. EDT",13098,13170,10332,-2766
ISNE,"11/1/2022 3 p.m. EDT",12925,13240,9980,-2945
ISNE,"11/1/2022 4 p.m. EDT",12907,13210,10053,-2854
ISNE,"11/1/2022 5 p.m. EDT",13294,13440,10398,-2896
ISNE,"11/1/2022 6 p.m. EDT",14063,14100,11154,-2909
ISNE,"11/1/2022 7 p.m. EDT",14491,14520,11415,-3076
ISNE,"11/1/2022 8 p.m. EDT",14034,14120,10868,-3166
ISNE,"11/1/2022 9 p.m. EDT",13313,13390,9975,-3338
ISNE,"11/1/2022 10 p.m. EDT",12417,12520,9325,-3092
ISNE,"11/1/2022 11 p.m. EDT",11577,11470,8759,-2818
ISNE,"11/2/2022 12 a.m. EDT",10720,10560,8561,-2159
ISNE,"11/2/2022 1 a.m. EDT",10538,9780,8828,-1710
ISNE,"11/2/2022 2 a.m. EDT",10311,9460,8936,-1375
ISNE,"11/2/2022 3 a.m. EDT",10110,9230,8630,-1480
ISNE,"11/2/2022 4 a.m. EDT",10077,9250,8410,-1667
ISNE,"11/2/2022 5 a.m. EDT",10332,9480,8884,-1448
ISNE,"11/2/2022 6 a.m. EDT",10755,10250,9166,-1589
ISNE,"11/2/2022 7 a.m. EDT",11717,11640,10131,-1586
ISNE,"11/2/2022 8 a.m. EDT",12709,12590,10468,-2241
ISNE,"11/2/2022 9 a.m. EDT",12495,12260,10073,-2422
ISNE,"11/2/2022 10 a.m. EDT",11489,11460,9677,-1812
ISNE,"11/2/2022 11 a.m. EDT",10974,10910,9752,-1222
ISNE,"11/2/2022 12 p.m. EDT",10810,10550,9909,-901
ISNE,"11/2/2022 1 p.m. EDT",10673,10380,9908,-765
ISNE,"11/2/2022 2 p.m. EDT",10500,10470,9793,-707
ISNE,"11/2/2022 3 p.m. EDT",10616,10720,9913,-703
ISNE,"11/2/2022 4 p.m. EDT",11329,11220,10142,-1187
ISNE,"11/2/2022 5 p.m. EDT",12526,12300,10677,-1849
ISNE,"11/2/2022 6 p.m. EDT",13580,13470,11299,-2281
ISNE,"11/2/2022 7 p.m. EDT",14109,13960,11520,-2589
ISNE,"11/2/2022 8 p.m. EDT",13707,13780,11186,-2521
ISNE,"11/2/2022 9 p.m. EDT",13096,13060,10532,-2564
ISNE,"11/2/2022 10 p.m. EDT",12270,12250,10100,-2170
ISNE,"11/2/2022 11 p.m. EDT",11232,11290,9577,-1655
ISNE,"11/3/2022 12 a.m. EDT",10387,10380,9378,-1009
ISNE,"11/3/2022 1 a.m. EDT",10176,9810,9035,-1141
ISNE,"11/3/2022 2 a.m. EDT",10051,9470,9088,-963
ISNE,"11/3/2022 3 a.m. EDT",9914,9340,9096,-818
ISNE,"11/3/2022 4 a.m. EDT",9924,9360,9283,-641
ISNE,"11/3/2022 5 a.m. EDT",10210,9710,9245,-965
ISNE,"11/3/2022 6 a.m. EDT",10766,10610,9512,-1254
ISNE,"11/3/2022 7 a.m. EDT",12139,12200,10497,-1642
ISNE,"11/3/2022 8 a.m. EDT",13253,13280,11608,-1645
ISNE,"11/3/2022 9 a.m. EDT",12987,12970,11504,-1483
ISNE,"11/3/2022 10 a.m. EDT",11808,11700,10209,-1599
ISNE,"11/3/2022 11 a.m. EDT",10914,10980,9840,-1074
ISNE,"11/3/2022 12 p.m. EDT",10368,10510,9956,-412
ISNE,"11/3/2022 1 p.m. EDT",10145,10170,10034,-111
ISNE,"11/3/2022 2 p.m. EDT",10377,10420,10051,-326
ISNE,"11/3/2022 3 p.m. EDT",10695,10820,10196,-499
ISNE,"11/3/2022 4 p.m. EDT",11313,11420,10282,-1031
ISNE,"11/3/2022 5 p.m. EDT",12550,12430,11070,-1480
ISNE,"11/3/2022 6 p.m. EDT",13612,13530,11880,-1732
ISNE,"11/3/2022 7 p.m. EDT",14131,13860,12451,-1680
ISNE,"11/3/2022 8 p.m. EDT",13743,13750,11854,-1889
ISNE,"11/3/2022 9 p.m. EDT",13120,13130,11165,-1955
ISNE,"11/3/2022 10 p.m. EDT",12323,12300,10665,-1658
ISNE,"11/3/2022 11 p.m. EDT",11330,11350,10147,-1183
ISNE,"11/4/2022 12 a.m. EDT",10544,10490,9718,-826
ISNE,"11/4/2022 1 a.m. EDT",10155,9830,9709,-446
ISNE,"11/4/2022 2 a.m. EDT",10049,9480,9544,-505
ISNE,"11/4/2022 3 a.m. EDT",10130,9300,9670,-460
ISNE,"11/4/2022 4 a.m. EDT",10134,9300,9666,-468
ISNE,"11/4/2022 5 a.m. EDT",10141,9580,9726,-415
ISNE,"11/4/2022 6 a.m. EDT",10742,10400,9833,-909
ISNE,"11/4/2022 7 a.m. EDT",11883,11860,10252,-1631
ISNE,"11/4/2022 8 a.m. EDT",12810,12850,11115,-1695
ISNE,"11/4/2022 9 a.m. EDT",12732,12730,11127,-1605
ISNE,"11/4/2022 10 a.m. EDT",11890,11800,11090,-800
ISNE,"11/4/2022 11 a.m. EDT",11009,11230,10734,-275
ISNE,"11/4/2022 12 p.m. EDT",10443,10910,10026,-417
ISNE,"11/4/2022 1 p.m. EDT",10485,10620,10148,-337
ISNE,"11/4/2022 2 p.m. EDT",10628,10890,10388,-240
ISNE,"11/4/2022 3 p.m. EDT",10847,11230,10378,-469
ISNE,"11/4/2022 4 p.m. EDT",11391,11780,10456,-935
ISNE,"11/4/2022 5 p.m. EDT",12581,12760,11093,-1488
ISNE,"11/4/2022 6 p.m. EDT",13418,13520,11835,-1583
ISNE,"11/4/2022 7 p.m. EDT",13719,13750,12055,-1664
ISNE,"11/4/2022 8 p.m. EDT",13283,13390,11733,-1550
ISNE,"11/4/2022 9 p.m. EDT",12731,12780,11335,-1396
ISNE,"11/4/2022 10 p.m. EDT",12045,12080,10825,-1220
ISNE,"11/4/2022 11 p.m. EDT",11198,11270,10167,-1031
ISNE,"11/5/2022 12 a.m. EDT",10398,10470,10132,-266
ISNE,"11/5/2022 1 a.m. EDT",10002,9870,9827,-175
ISNE,"11/5/2022 2 a.m. EDT",9839,9520,9634,-205
ISNE,"11/5/2022 3 a.m. EDT",9924,9250,9609,-315
ISNE,"11/5/2022 4 a.m. EDT",9853,9010,9574,-279
ISNE,"11/5/2022 5 a.m. EDT",9916,9120,9558,-358
ISNE,"11/5/2022 6 a.m. EDT",10209,9430,9915,-294
ISNE,"11/5/2022 7 a.m. EDT",10557,10220,10181,-376
ISNE,"11/5/2022 8 a.m. EDT",10834,10950,10243,-591
ISNE,"11/5/2022 9 a.m. EDT",11019,11230,10459,-560
ISNE,"11/5/2022 10 a.m. EDT",10860,10980,10501,-359
ISNE,"11/5/2022 11 a.m. EDT",10557,10650,10411,-146
ISNE,"11/5/2022 12 p.m. EDT",10383,10630,10396,13
ISNE,"11/5/2022 1 p.m. EDT",10553,10670,10474,-79
ISNE,"11/5/2022 2 p.m. EDT",10693,10860,10817,124
ISNE,"11/5/2022 3 p.m. EDT",10793,11280,10891,98
ISNE,"11/5/2022 4 p.m. EDT",11383,11660,11352,-31
ISNE,"11/5/2022 5 p.m. EDT",12132,12500,11584,-548
ISNE,"11/5/2022 6 p.m. EDT",12896,13190,11898,-998
ISNE,"11/5/2022 7 p.m. EDT",13286,13500,11980,-1306
ISNE,"11/5/2022 8 p.m. EDT",12870,13100,11971,-899
ISNE,"11/5/2022 9 p.m. EDT",12393,12540,11890,-503
ISNE,"11/5/2022 10 p.m. EDT",11816,11970,11343,-473
ISNE,"11/5/2022 11 p.m. EDT",11137,11250,10965,-172
ISNE,"11/6/2022 12 a.m. EDT",10425,10610,10329,-96
ISNE,"11/6/2022 1 a.m. EDT",10264,9850,9949,-315
ISNE,"11/6/2022 1 a.m. EST",10252,9440,9726,-526
ISNE,"11/6/2022 2 a.m. EST",10138,9440,9570,-568
ISNE,"11/6/2022 3 a.m. EST",10133,9030,9798,-335
ISNE,"11/6/2022 4 a.m. EST",9948,8980,9783,-165
ISNE,"11/6/2022 5 a.m. EST",9890,9070,9911,21
ISNE,"11/6/2022 6 a.m. EST",10344,9350,10076,-268
ISNE,"11/6/2022 7 a.m. EST",10651,9840,10373,-278
ISNE,"11/6/2022 8 a.m. EST",10809,10280,10210,-599
ISNE,"11/6/2022 9 a.m. EST",10923,10670,10242,-681
ISNE,"11/6/2022 10 a.m. EST",10806,10740,10145,-661
ISNE,"11/6/2022 11 a.m. EST",10782,11040,10219,-563
ISNE,"11/6/2022 12 p.m. EST",11262,11340,10747,-515
ISNE,"11/6/2022 1 p.m. EST",11766,11500,10855,-911
ISNE,"11/6/2022 2 p.m. EST",12059,11860,10629,-1430
ISNE,"11/6/2022 3 p.m. EST",12351,12290,10713,-1638
ISNE,"11/6/2022 4 p.m. EST",12669,13040,10667,-2002
ISNE,"11/6/2022 5 p.m. EST",13476,13950,11229,-2247
ISNE,"11/6/2022 6 p.m. EST",14198,14750,12064,-2134
ISNE,"11/6/2022 7 p.m. EST",13891,14450,11769,-2122
ISNE,"11/6/2022 8 p.m. EST",13314,13150,11137,-2177
ISNE,"11/6/2022 9 p.m. EST",12630,12630,10750,-1880
ISNE,"11/6/2022 10 p.m. EST",11810,11830,10704,-1106
ISNE,"11/6/2022 11 p.m. EST",10948,10950,10215,-733
ISNE,"11/7/2022 12 a.m. EST",10220,10140,9642,-578
ISNE,"11/7/2022 1 a.m. EST",10141,10210,9414,-727
ISNE,"11/7/2022 2 a.m. EST",10005,9990,9229,-776
ISNE,"11/7/2022 3 a.m. EST",10079,9750,9285,-794
ISNE,"11/7/2022 4 a.m. EST",10100,9140,9389,-711
ISNE,"11/7/2022 5 a.m. EST",10347,9460,9534,-813
ISNE,"11/7/2022 6 a.m. EST",11205,10330,9785,-1420
ISNE,"11/7/2022 7 a.m. EST",12321,12160,10485,-1836
ISNE,"11/7/2022 8 a.m. EST",12762,12830,10780,-1982
ISNE,"11/7/2022 9 a.m. EST",12531,12910,10528,-2003
ISNE,"11/7/2022 10 a.m. EST",11940,12370,10410,-1530
ISNE,"11/7/2022 11 a.m. EST",11876,12090,10624,-1252
ISNE,"11/7/2022 12 p.m. EST",11963,11570,10720,-1243
ISNE,"11/7/2022 1 p.m. EST",11958,11540,10925,-1033
ISNE,"11/7/2022 2 p.m. EST",12365,11680,11097,-1268
ISNE,"11/7/2022 3 p.m. EST",12415,12160,11129,-1286
ISNE,"11/7/2022 4 p.m. EST",13286,13160,11941,-1345
ISNE,"11/7/2022 5 p.m. EST",14059,14040,12564,-1495
ISNE,"11/7/2022 6 p.m. EST",14675,15000,12974,-1701
ISNE,"11/7/2022 7 p.m. EST",14205,14850,12129,-2076
ISNE,"11/7/2022 8 p.m. EST",13518,14020,11577,-1941
ISNE,"11/7/2022 9 p.m. EST",12703,13230,10986,-1717
ISNE,"11/7/2022 10 p.m. EST",11812,12370,10797,-1015
ISNE,"11/7/2022 11 p.m. EST",11090,11400,10265,-825
ISNE,"11/8/2022 12 a.m. EST",10228,10500,9733,-495
ISNE,"11/8/2022 1 a.m. EST",10030,9430,9188,-842
ISNE,"11/8/2022 2 a.m. EST",10055,9130,9172,-883
ISNE,"11/8/2022 3 a.m. EST",10089,9010,9255,-834
ISNE,"11/8/2022 4 a.m. EST",10099,9030,9319,-780
ISNE,"11/8/2022 5 a.m. EST",10317,9310,9467,-850
ISNE,"11/8/2022 6 a.m. EST",10724,10160,9428,-1296
ISNE,"11/8/2022 7 a.m. EST",11574,11660,9935,-1639
ISNE,"11/8/2022 8 a.m. EST",11903,12720,9990,-1913
ISNE,"11/8/2022 9 a.m. EST",11264,12120,9455,-1809
ISNE,"11/8/2022 10 a.m. EST",11007,10570,9972,-1035
ISNE,"11/8/2022 11 a.m. EST",10581,10060,9722,-859
ISNE,"11/8/2022 12 p.m. EST",10196,9890,9555,-641
ISNE,"11/8/2022 1 p.m. EST",10070,9940,9459,-611
ISNE,"11/8/2022 2 p.m. EST",10384,10320,9681,-703
ISNE,"11/8/2022 3 p.m. EST",11190,11010,10209,-981
ISNE,"11/8/2022 4 p.m. EST",12413,12180,11083,-1330
ISNE,"11/8/2022 5 p.m. EST",13656,13770,12036,-1620
ISNE,"11/8/2022 6 p.m. EST",14528,14820,12832,-1696
ISNE,"11/8/2022 7 p.m. EST",14373,14880,12616,-1757
ISNE,"11/8/2022 8 p.m. EST",13970,14400,12141,-1829
ISNE,"11/8/2022 9 p.m. EST",13380,13750,11447,-1933
ISNE,"11/8/2022 10 p.m. EST",12543,12920,10405,-2138
ISNE,"11/8/2022 11 p.m. EST",11728,11900,9751,-1977
ISNE,"11/9/2022 12 a.m. EST",10997,11070,9643,-1354
ISNE,"11/9/2022 1 a.m. EST",10817,10290,9654,-1163
ISNE,"11/9/2022 2 a.m. EST",10554,9990,9456,-1098
ISNE,"11/9/2022 3 a.m. EST",10427,9880,9314,-1113
ISNE,"11/9/2022 4 a.m. EST",10492,9950,9252,-1240
ISNE,"11/9/2022 5 a.m. EST",10562,10270,9082,-1480
ISNE,"11/9/2022 6 a.m. EST",11311,11160,9483,-1828
ISNE,"11/9/2022 7 a.m. EST",12858,12420,11166,-1692
ISNE,"11/9/2022 8 a.m. EST",13213,13210,11783,-1430
ISNE,"11/9/2022 9 a.m. EST",12165,12610,11053,-1112
ISNE,"11/9/2022 10 a.m. EST",11346,11260,10304,-1042
ISNE,"11/9/2022 11 a.m. EST",10643,10410,10035,-608
ISNE,"11/9/2022 12 p.m. EST",10228,10020,9774,-454
ISNE,"11/9/2022 1 p.m. EST",10221,9850,9805,-416
ISNE,"11/9/2022 2 p.m. EST",10642,10280,10168,-474
ISNE,"11/9/2022 3 p.m. EST",11476,11110,10906,-570
ISNE,"11/9/2022 4 p.m. EST",12734,12460,11481,-1253
ISNE,"11/9/2022 5 p.m. EST",13971,13680,12569,-1402
ISNE,"11/9/2022 6 p.m. EST",14889,14880,13578,-1311
ISNE,"11/9/2022 7 p.m. EST",14715,14810,13611,-1104
ISNE,"11/9/2022 8 p.m. EST",14271,14350,13091,-1180
ISNE,"11/9/2022 9 p.m. EST",13648,13650,12286,-1362
ISNE,"11/9/2022 10 p.m. EST",12770,12770,11120,-1650
ISNE,"11/9/2022 11 p.m. EST",11748,11830,10581,-1167
ISNE,"11/10/2022 12 a.m. EST",10878,11000,10137,-741
ISNE,"11/10/2022 1 a.m. EST",10650,10320,9812,-838
ISNE,"11/10/2022 2 a.m. EST",10628,10000,9750,-878
ISNE,"11/10/2022 3 a.m. EST",10688,9830,9879,-809
ISNE,"11/10/2022 4 a.m. EST",10717,9900,9885,-832
ISNE,"11/10/2022 5 a.m. EST",10788,10160,9983,-805
ISNE,"11/10/2022 6 a.m. EST",11501,11030,10421,-1080
ISNE,"11/10/2022 7 a.m. EST",12640,12310,11190,-1450
ISNE,"11/10/2022 8 a.m. EST",12910,12570,11433,-1477
ISNE,"11/10/2022 9 a.m. EST",11961,11990,11045,-916
ISNE,"11/10/2022 10 a.m. EST",11041,11200,10540,-501
ISNE,"11/10/2022 11 a.m. EST",10515,10600,10190,-325
ISNE,"11/10/2022 12 p.m. EST",10527,10440,10057,-470
ISNE,"11/10/2022 1 p.m. EST",10579,10390,10007,-572
ISNE,"11/10/2022 2 p.m. EST",11050,10620,10437,-613
ISNE,"11/10/2022 3 p.m. EST",11581,11290,11006,-575
ISNE,"11/10/2022 4 p.m. EST",12644,12250,11366,-1278
ISNE,"11/10/2022 5 p.m. EST",13613,13470,12328,-1285
ISNE,"11/10/2022 6 p.m. EST",14301,14240,13164,-1137
ISNE,"11/10/2022 7 p.m. EST",14019,14090,12844,-1175
ISNE,"11/10/2022 8 p.m. EST",13486,13630,12272,-1214
ISNE,"11/10/2022 9 p.m. EST",12865,12970,11774,-1091
ISNE,"11/10/2022 10 p.m. EST",12076,12180,11090,-986
ISNE,"11/10/2022 11 p.m. EST",11230,11190,10615,-615
ISNE,"11/11/2022 12 a.m. EST",10572,10370,10109,-463
ISNE,"11/11/2022 1 a.m. EST",10479,9770,9718,-761
ISNE,"11/11/2022 2 a.m. EST",10248,9430,9513,-735
ISNE,"11/11/2022 3 a.m. EST",10048,9240,9290,-758
ISNE,"11/11/2022 4 a.m. EST",10026,9230,9211,-815
ISNE,"11/11/2022 5 a.m. EST",10070,9400,9305,-765
ISNE,"11/11/2022 6 a.m. EST",10405,10160,9808,-597
ISNE,"11/11/2022 7 a.m. EST",11137,11240,10066,-1071
ISNE,"11/11/2022 8 a.m. EST",11747,11840,10558,-1189
ISNE,"11/11/2022 9 a.m. EST",11982,12170,10959,-1023
ISNE,"11/11/2022 10 a.m. EST",12016,12130,10880,-1136
ISNE,"11/11/2022 11 a.m. EST",12170,12140,11103,-1067
ISNE,"11/11/2022 12 p.m. EST",12265,12200,11335,-930
ISNE,"11/11/2022 1 p.m. EST",12513,12460,11565,-948
ISNE,"11/11/2022 2 p.m. EST",12854,12890,11761,-1093
ISNE,"11/11/2022 3 p.m. EST",13084,13140,11779,-1305
ISNE,"11/11/2022 4 p.m. EST",13296,13370,12007,-1289
ISNE,"11/11/2022 5 p.m. EST",13888,14160,12577,-1311
ISNE,"11/11/2022 6 p.m. EST",14231,14720,12790,-1441
ISNE,"11/11/2022 7 p.m. EST",13824,14130,12410,-1414
ISNE,"11/11/2022 8 p.m. EST",13284,13440,11862,-1422
ISNE,"11/11/2022 9 p.m. EST",12744,12780,11478,-1266
ISNE,"11/11/2022 10 p.m. EST",12085,12120,11013,-1072
ISNE,"11/11/2022 11 p.m. EST",11304,11360,10401,-903
ISNE,"11/12/2022 12 a.m. EST",10582,10750,9659,-923
ISNE,"11/12/2022 1 a.m. EST",10307,10250,9779,-528
ISNE,"11/12/2022 2 a.m. EST",10365,9840,9638,-727
ISNE,"11/12/2022 3 a.m. EST",10280,9710,9411,-869
ISNE,"11/12/2022 4 a.m. EST",10188,9590,9106,-1082
ISNE,"11/12/2022 5 a.m. EST",10249,9680,9255,-994
ISNE,"11/12/2022 6 a.m. EST",10306,9960,9428,-878
ISNE,"11/12/2022 7 a.m. EST",10592,10400,9943,-649
ISNE,"11/12/2022 8 a.m. EST",11392,11060,10113,-1279
ISNE,"11/12/2022 9 a.m. EST",11901,11540,10463,-1438
ISNE,"11/12/2022 10 a.m. EST",11828,11840,10535,-1293
ISNE,"11/12/2022 11 a.m. EST",11127,11420,10570,-557
ISNE,"11/12/2022 12 p.m. EST",11224,11080,10887,-337
ISNE,"11/12/2022 1 p.m. EST",11249,10810,10760,-489
ISNE,"11/12/2022 2 p.m. EST",11261,10910,10856,-405
ISNE,"11/12/2022 3 p.m. EST",11281,11600,11116,-165
ISNE,"11/12/2022 4 p.m. EST",11960,12260,11656,-304
ISNE,"11/12/2022 5 p.m. EST",12695,13080,11533,-1162
ISNE,"11/12/2022 6 p.m. EST",13216,13740,12105,-1111
ISNE,"11/12/2022 7 p.m. EST",12822,13390,11764,-1058
ISNE,"11/12/2022 8 p.m. EST",12278,12620,11359,-919
ISNE,"11/12/2022 9 p.m. EST",11773,12020,11050,-723
ISNE,"11/12/2022 10 p.m. EST",11171,11390,10480,-691
ISNE,"11/12/2022 11 p.m. EST",10483,10670,10029,-454
ISNE,"11/13/2022 12 a.m. EST",9800,9990,9496,-304
ISNE,"11/13/2022 1 a.m. EST",9273,9430,8752,-521
ISNE,"11/13/2022 2 a.m. EST",9203,9050,8617,-586
ISNE,"11/13/2022 3 a.m. EST",9481,8860,8625,-856
ISNE,"11/13/2022 4 a.m. EST",9174,8680,8337,-837
ISNE,"11/13/2022 5 a.m. EST",9406,8730,8640,-766
ISNE,"11/13/2022 6 a.m. EST",9097,8850,8420,-677
ISNE,"11/13/2022 7 a.m. EST",9324,9130,8898,-426
ISNE,"11/13/2022 8 a.m. EST",9937,9730,9244,-693
ISNE,"11/13/2022 9 a.m. EST",10760,10750,10223,-537
ISNE,"11/13/2022 10 a.m. EST",11469,11260,10696,-773
ISNE,"11/13/2022 11 a.m. EST",11915,11620,10929,-986
ISNE,"11/13/2022 12 p.m. EST",12181,11890,11106,-1075
ISNE,"11/13/2022 1 p.m. EST",12126,12010,10804,-1322
ISNE,"11/13/2022 2 p.m. EST",11869,12140,10239,-1630
ISNE,"11/13/2022 3 p.m. EST",11899,12220,10439,-1460
ISNE,"11/13/2022 4 p.m. EST",12370,12670,11000,-1370
ISNE,"11/13/2022 5 p.m. EST",13229,13610,11841,-1388
ISNE,"11/13/2022 6 p.m. EST",13983,14560,13155,-828
ISNE,"11/13/2022 7 p.m. EST",13765,14260,12664,-1101
ISNE,"11/13/2022 8 p.m. EST",13271,13680,12147,-1124
ISNE,"11/13/2022 9 p.m. EST",12734,13010,11404,-1330
ISNE,"11/13/2022 10 p.m. EST",12015,12270,10439,-1576
ISNE,"11/13/2022 11 p.m. EST",11192,11460,9919,-1273
ISNE,"11/14/2022 12 a.m. EST",10443,10750,9388,-1055
ISNE,"11/14/2022 1 a.m. EST",10346,10000,8953,-1393
ISNE,"11/14/2022 2 a.m. EST",10317,9770,9258,-1059
ISNE,"11/14/2022 3 a.m. EST",10268,9720,9337,-931
ISNE,"11/14/2022 4 a.m. EST",10193,9810,9163,-1030
ISNE,"11/14/2022 5 a.m. EST",10461,10240,9464,-997
ISNE,"11/14/2022 6 a.m. EST",11365,11260,9934,-1431
ISNE,"11/14/2022 7 a.m. EST",12728,12790,11448,-1280
ISNE,"11/14/2022 8 a.m. EST",13298,13330,12101,-1197
ISNE,"11/14/2022 9 a.m. EST",12553,12570,11427,-1126
ISNE,"11/14/2022 10 a.m. EST",11677,11760,10635,-1042
ISNE,"11/14/2022 11 a.m. EST",11265,11380,9927,-1338
ISNE,"11/14/2022 12 p.m. EST",11120,11210,9795,-1325
ISNE,"11/14/2022 1 p.m. EST",11155,11260,9889,-1266
ISNE,"11/14/2022 2 p.m. EST",11582,11580,10358,-1224
ISNE,"11/14/2022 3 p.m. EST",12154,12110,10779,-1375
ISNE,"11/14/2022 4 p.m. EST",13420,13320,11957,-1463
ISNE,"11/14/2022 5 p.m. EST",14716,14540,13299,-1417
ISNE,"11/14/2022 6 p.m. EST",15655,15840,14189,-1466
ISNE,"11/14/2022 7 p.m. EST",15536,15630,13973,-1563
ISNE,"11/14/2022 8 p.m. EST",15157,15140,13649,-1508
ISNE,"11/14/2022 9 p.m. EST",14553,14420,13086,-1467
ISNE,"11/14/2022 10 p.m. EST",13724,13540,11894,-1830
ISNE,"11/14/2022 11 p.m. EST",12705,12580,10697,-2008
ISNE,"11/15/2022 12 a.m. EST",11911,11760,9761,-2150
ISNE,"11/15/2022 1 a.m. EST",11715,11280,9460,-2255
ISNE,"11/15/2022 2 a.m. EST",11724,11010,9324,-2400
ISNE,"11/15/2022 3 a.m. EST",11661,10920,9472,-2189
ISNE,"11/15/2022 4 a.m. EST",11747,11020,9513,-2234
ISNE,"11/15/2022 5 a.m. EST",11668,11410,9555,-2113
ISNE,"11/15/2022 6 a.m. EST",12393,12400,10431,-1962
ISNE,"11/15/2022 7 a.m. EST",13838,13900,12144,-1694
ISNE,"11/15/2022 8 a.m. EST",14282,14300,12932,-1350
ISNE,"11/15/2022 9 a.m. EST",13413,13400,12119,-1294
ISNE,"11/15/2022 10 a.m. EST",12392,12170,11129,-1263
ISNE,"11/15/2022 11 a.m. EST",12234,11850,11235,-999
ISNE,"11/15/2022 12 p.m. EST",12371,11780,11681,-690
ISNE,"11/15/2022 1 p.m. EST",12670,11810,11827,-843
ISNE,"11/15/2022 2 p.m. EST",13094,12180,12258,-836
ISNE,"11/15/2022 3 p.m. EST",13588,13290,12729,-859
ISNE,"11/15/2022 4 p.m. EST",14283,14180,13362,-921
ISNE,"11/15/2022 5 p.m. EST",15190,15150,14293,-897
ISNE,"11/15/2022 6 p.m. EST",15747,15980,14726,-1021
ISNE,"11/15/2022 7 p.m. EST",15530,15720,14244,-1286
ISNE,"11/15/2022 8 p.m. EST",15140,15190,14033,-1107
ISNE,"11/15/2022 9 p.m. EST",14521,14470,13463,-1058
ISNE,"11/15/2022 10 p.m. EST",13632,13570,12487,-1145
ISNE,"11/15/2022 11 p.m. EST",12626,12510,11461,-1165
ISNE,"11/16/2022 12 a.m. EST",11769,11700,10559,-1210
ISNE,"11/16/2022 1 a.m. EST",11659,11160,10146,-1513
ISNE,"11/16/2022 2 a.m. EST",11569,10820,10116,-1453
ISNE,"11/16/2022 3 a.m. EST",11384,10630,9866,-1518
ISNE,"11/16/2022 4 a.m. EST",11363,10620,9762,-1601
ISNE,"11/16/2022 5 a.m. EST",11668,10940,9992,-1676
ISNE,"11/16/2022 6 a.m. EST",11818,11770,10501,-1317
ISNE,"11/16/2022 7 a.m. EST",13101,13160,11481,-1620
ISNE,"11/16/2022 8 a.m. EST",14020,14050,12551,-1469
ISNE,"11/16/2022 9 a.m. EST",14350,14370,13121,-1229
ISNE,"11/16/2022 10 a.m. EST",14443,14440,13298,-1145
ISNE,"11/16/2022 11 a.m. EST",14350,14180,13216,-1134
ISNE,"11/16/2022 12 p.m. EST",14078,13950,13012,-1066
ISNE,"11/16/2022 1 p.m. EST",13853,13830,12602,-1251
ISNE,"11/16/2022 2 p.m. EST",13654,13790,12349,-1305
ISNE,"11/16/2022 3 p.m. EST",13552,13850,12179,-1373
ISNE,"11/16/2022 4 p.m. EST",13974,14280,12682,-1292
ISNE,"11/16/2022 5 p.m. EST",14920,15120,13641,-1279
ISNE,"11/16/2022 6 p.m. EST",15487,15900,14195,-1292
ISNE,"11/16/2022 7 p.m. EST",15307,15740,13755,-1552
ISNE,"11/16/2022 8 p.m. EST",14883,15030,13185,-1698
ISNE,"11/16/2022 9 p.m. EST",14248,14420,12420,-1828
ISNE,"11/16/2022 10 p.m. EST",13426,13590,11621,-1805
ISNE,"11/16/2022 11 p.m. EST",12824,12530,10910,-1914
ISNE,"11/17/2022 12 a.m. EST",12053,11630,10229,-1824
ISNE,"11/17/2022 1 a.m. EST",11714,10950,9955,-1759
ISNE,"11/17/2022 2 a.m. EST",11396,10650,9612,-1784
ISNE,"11/17/2022 3 a.m. EST",11268,10540,9409,-1859
ISNE,"11/17/2022 4 a.m. EST",11306,10550,9545,-1761
ISNE,"11/17/2022 5 a.m. EST",11579,11050,9896,-1683
ISNE,"11/17/2022 6 a.m. EST",12024,11950,10461,-1563
ISNE,"11/17/2022 7 a.m. EST",13310,13360,11899,-1411
ISNE,"11/17/2022 8 a.m. EST",13974,13910,12587,-1387
ISNE,"11/17/2022 9 a.m. EST",13433,13510,12139,-1294
ISNE,"11/17/2022 10 a.m. EST",12557,12940,11314,-1243
ISNE,"11/17/2022 11 a.m. EST",12202,12570,10992,-1210
ISNE,"11/17/2022 12 p.m. EST",12433,12430,11168,-1265
ISNE,"11/17/2022 1 p.m. EST",12550,12420,11217,-1333
ISNE,"11/17/2022 2 p.m. EST",12669,12760,11395,-1274
ISNE,"11/17/2022 3 p.m. EST",13108,13200,11875,-1233
ISNE,"11/17/2022 4 p.m. EST",13955,13950,12761,-1194
ISNE,"11/17/2022 5 p.m. EST",15034,15030,13866,-1168
ISNE,"11/17/2022 6 p.m. EST",15723,15700,14596,-1127
ISNE,"11/17/2022 7 p.m. EST",15572,15650,14256,-1316
ISNE,"11/17/2022 8 p.m. EST",15232,15220,13637,-1595
ISNE,"11/17/2022 9 p.m. EST",14692,14630,12990,-1702
ISNE,"11/17/2022 10 p.m. EST",13905,13820,12145,-1760
ISNE,"11/17/2022 11 p.m. EST",13047,12820,11332,-1715
ISNE,"11/18/2022 12 a.m. EST",12530,11950,10723,-1807
ISNE,"11/18/2022 1 a.m. EST",12170,11400,10335,-1835
ISNE,"11/18/2022 2 a.m. EST",11851,11090,9844,-2007
ISNE,"11/18/2022 3 a.m. EST",11711,10960,9878,-1833
ISNE,"11/18/2022 4 a.m. EST",11610,10970,9958,-1652
ISNE,"11/18/2022 5 a.m. EST",12055,11390,10446,-1609
ISNE,"11/18/2022 6 a.m. EST",12296,12290,11046,-1250
ISNE,"11/18/2022 7 a.m. EST",13645,13760,12286,-1359
ISNE,"11/18/2022 8 a.m. EST",14217,14290,12843,-1374
ISNE,"11/18/2022 9 a.m. EST",13585,13660,12488,-1097
ISNE,"11/18/2022 10 a.m. EST",12807,12720,11588,-1219
ISNE,"11/18/2022 11 a.m. EST",12342,12260,11074,-1268
ISNE,"11/18/2022 12 p.m. EST",11847,11760,10476,-1371
ISNE,"11/18/2022 1 p.m. EST",11872,11820,10491,-1381
ISNE,"11/18/2022 2 p.m. EST",12430,12050,11041,-1389
ISNE,"11/18/2022 3 p.m. EST",13200,12860,11851,-1349
ISNE,"11/18/2022 4 p.m. EST",13865,13690,12530,-1335
ISNE,"11/18/2022 5 p.m. EST",14936,14750,13841,-1095
ISNE,"11/18/2022 6 p.m. EST",15492,15460,14390,-1102
ISNE,"11/18/2022 7 p.m. EST",15230,15320,13867,-1363
ISNE,"11/18/2022 8 p.m. EST",14834,14890,13417,-1417
ISNE,"11/18/2022 9 p.m. EST",14474,14390,13197,-1277
ISNE,"11/18/2022 10 p.m. EST",13833,13750,12429,-1404
ISNE,"11/18/2022 11 p.m. EST",13264,12920,11801,-1463
ISNE,"11/19/2022 12 a.m. EST",12673,12130,11018,-1655
ISNE,"11/19/2022 1 a.m. EST",11959,11490,10852,-1107
ISNE,"11/19/2022 2 a.m. EST",11695,11140,10987,-708
ISNE,"11/19/2022 3 a.m. EST",11646,10990,10870,-776
ISNE,"11/19/2022 4 a.m. EST",11672,10970,10864,-808
ISNE,"11/19/2022 5 a.m. EST",11486,11150,10817,-669
ISNE,"11/19/2022 6 a.m. EST",11707,11580,10924,-783
ISNE,"11/19/2022 7 a.m. EST",12283,12270,11387,-896
ISNE,"11/19/2022 8 a.m. EST",12716,12440,11791,-925
ISNE,"11/19/2022 9 a.m. EST",12189,12120,11263,-926
ISNE,"11/19/2022 10 a.m. EST",11354,11550,10771,-583
ISNE,"11/19/2022 11 a.m. EST",10707,10700,10204,-503
ISNE,"11/19/2022 12 p.m. EST",10534,10500,9908,-626
ISNE,"11/19/2022 1 p.m. EST",10896,10540,10048,-848
ISNE,"11/19/2022 2 p.m. EST",11311,10770,10336,-975
ISNE,"11/19/2022 3 p.m. EST",12097,11740,11164,-933
ISNE,"11/19/2022 4 p.m. EST",12755,12870,11804,-951
ISNE,"11/19/2022 5 p.m. EST",13256,14090,12254,-1002
ISNE,"11/19/2022 6 p.m. EST",14941,14890,13976,-965
ISNE,"11/19/2022 7 p.m. EST",14749,14850,13576,-1173
ISNE,"11/19/2022 8 p.m. EST",14392,14440,13516,-876
ISNE,"11/19/2022 9 p.m. EST",14011,14000,13204,-807
ISNE,"11/19/2022 10 p.m. EST",13433,13420,12488,-945
ISNE,"11/19/2022 11 p.m. EST",12724,12740,11663,-1061
ISNE,"11/20/2022 12 a.m. EST",12092,12040,10627,-1465
ISNE,"11/20/2022 1 a.m. EST",11780,11560,10049,-1731
ISNE,"11/20/2022 2 a.m. EST",11791,11230,9955,-1836
ISNE,"11/20/2022 3 a.m. EST",11748,11050,9589,-2159
ISNE,"11/20/2022 4 a.m. EST",11780,10950,9641,-2139
ISNE,"11/20/2022 5 a.m. EST",11851,11070,9702,-2149
ISNE,"11/20/2022 6 a.m. EST",12121,11340,10065,-2056
ISNE,"11/20/2022 7 a.m. EST",12175,11890,10231,-1944
ISNE,"11/20/2022 8 a.m. EST",12245,12240,10319,-1926
ISNE,"11/20/2022 9 a.m. EST",12063,11870,10435,-1628
ISNE,"11/20/2022 10 a.m. EST",11654,11300,10158,-1496
ISNE,"11/20/2022 11 a.m. EST",11129,11060,9761,-1368
ISNE,"11/20/2022 12 p.m. EST",11232,11140,9793,-1439
ISNE,"11/20/2022 1 p.m. EST",11640,11380,10222,-1418
ISNE,"11/20/2022 2 p.m. EST",12026,11660,10541,-1485
ISNE,"11/20/2022 3 p.m. EST",12852,12450,11222,-1630
ISNE,"11/20/2022 4 p.m. EST",14044,13770,12458,-1586
ISNE,"11/20/2022 5 p.m. EST",15374,15250,13599,-1775
ISNE,"11/20/2022 6 p.m. EST",16139,16100,14589,-1550
ISNE,"11/20/2022 7 p.m. EST",15979,15930,14305,-1674
ISNE,"11/20/2022 8 p.m. EST",15626,15470,13942,-1684
ISNE,"11/20/2022 9 p.m. EST",15084,14900,13464,-1620
ISNE,"11/20/2022 10 p.m. EST",14324,14180,12190,-2134
ISNE,"11/20/2022 11 p.m. EST",13409,13250,11472,-1937
ISNE,"11/21/2022 12 a.m. EST",12626,12470,10676,-1950
ISNE,"11/21/2022 1 a.m. EST",12619,12140,10235,-2384
ISNE,"11/21/2022 2 a.m. EST",12908,11900,10419,-2489
ISNE,"11/21/2022 3 a.m. EST",12901,11810,10379,-2522
ISNE,"11/21/2022 4 a.m. EST",12865,11900,10373,-2492
ISNE,"11/21/2022 5 a.m. EST",13095,12330,10691,-2404
ISNE,"11/21/2022 6 a.m. EST",13569,13310,11435,-2134
ISNE,"11/21/2022 7 a.m. EST",14779,14820,13025,-1754
ISNE,"11/21/2022 8 a.m. EST",15384,15410,13865,-1519
ISNE,"11/21/2022 9 a.m. EST",14641,14640,13046,-1595
ISNE,"11/21/2022 10 a.m. EST",13673,13550,12249,-1424
ISNE,"11/21/2022 11 a.m. EST",13079,12940,11843,-1236
ISNE,"11/21/2022 12 p.m. EST",12891,12700,11656,-1235
ISNE,"11/21/2022 1 p.m. EST",13167,12780,11650,-1517
ISNE,"11/21/2022 2 p.m. EST",13408,13040,11740,-1668
ISNE,"11/21/2022 3 p.m. EST",13750,13560,12034,-1716
ISNE,"11/21/2022 4 p.m. EST",14837,14590,13304,-1533
ISNE,"11/21/2022 5 p.m. EST",16022,15780,14360,-1662
ISNE,"11/21/2022 6 p.m. EST",16661,16580,15024,-1637
ISNE,"11/21/2022 7 p.m. EST",16468,16420,14655,-1813
ISNE,"11/21/2022 8 p.m. EST",16043,15910,13996,-2047
ISNE,"11/21/2022 9 p.m. EST",15389,15230,13503,-1886
ISNE,"11/21/2022 10 p.m. EST",14423,14290,12467,-1956
ISNE,"11/21/2022 11 p.m. EST",13309,13180,11064,-2245
ISNE,"11/22/2022 12 a.m. EST",12342,12300,9890,-2452
ISNE,"11/22/2022 1 a.m. EST",11713,11680,9346,-2367
ISNE,"11/22/2022 2 a.m. EST",11868,11300,9616,-2252
ISNE,"11/22/2022 3 a.m. EST",12003,11160,9902,-2101
ISNE,"11/22/2022 4 a.m. EST",11996,11190,9859,-2137
ISNE,"11/22/2022 5 a.m. EST",12045,11550,9907,-2138
ISNE,"11/22/2022 6 a.m. EST",12723,12520,10903,-1820
ISNE,"11/22/2022 7 a.m. EST",13944,14000,12427,-1517
ISNE,"11/22/2022 8 a.m. EST",14535,14530,12856,-1679
ISNE,"11/22/2022 9 a.m. EST",13650,13650,12059,-1591
ISNE,"11/22/2022 10 a.m. EST",12577,12400,10952,-1625
ISNE,"11/22/2022 11 a.m. EST",12407,11780,10841,-1566
ISNE,"11/22/2022 12 p.m. EST",11897,11480,10608,-1289
ISNE,"11/22/2022 1 p.m. EST",11817,11440,10311,-1506
ISNE,"11/22/2022 2 p.m. EST",12214,11810,10646,-1568
ISNE,"11/22/2022 3 p.m. EST",13080,12560,11283,-1797
ISNE,"11/22/2022 4 p.m. EST",13717,13690,12182,-1535
ISNE,"11/22/2022 5 p.m. EST",14921,15120,13167,-1754
ISNE,"11/22/2022 6 p.m. EST",15652,15900,13874,-1778
ISNE,"11/22/2022 7 p.m. EST",15549,15710,13748,-1801
ISNE,"11/22/2022 8 p.m. EST",15198,15300,13399,-1799
ISNE,"11/22/2022 9 p.m. EST",14660,14690,12771,-1889
ISNE,"11/22/2022 10 p.m. EST",13893,13850,12064,-1829
ISNE,"11/22/2022 11 p.m. EST",12969,12860,11094,-1875
ISNE,"11/23/2022 12 a.m. EST",12279,11910,10206,-2073
ISNE,"11/23/2022 1 a.m. EST",11696,11400,9358,-2338
ISNE,"11/23/2022 2 a.m. EST",11643,11050,9105,-2538
ISNE,"11/23/2022 3 a.m. EST",11472,10890,8978,-2494
ISNE,"11/23/2022 4 a.m. EST",11477,10900,9020,-2457
ISNE,"11/23/2022 5 a.m. EST",11489,11250,9245,-2244
ISNE,"11/23/2022 6 a.m. EST",12160,12090,10155,-2005
ISNE,"11/23/2022 7 a.m. EST",13359,13400,11480,-1879
ISNE,"11/23/2022 8 a.m. EST",14113,14050,12309,-1804
ISNE,"11/23/2022 9 a.m. EST",13808,13790,12042,-1766
ISNE,"11/23/2022 10 a.m. EST",12941,12750,11363,-1578
ISNE,"11/23/2022 11 a.m. EST",12275,12070,10884,-1391
ISNE,"11/23/2022 12 p.m. EST",12468,11730,10796,-1672
ISNE,"11/23/2022 1 p.m. EST",12419,11570,10764,-1655
ISNE,"11/23/2022 2 p.m. EST",12819,11990,11019,-1800
ISNE,"11/23/2022 3 p.m. EST",13364,12840,11743,-1621
ISNE,"11/23/2022 4 p.m. EST",13863,13750,12363,-1500
ISNE,"11/23/2022 5 p.m. EST",14807,14920,13266,-1541
ISNE,"11/23/2022 6 p.m. EST",15358,15710,13656,-1702
ISNE,"11/23/2022 7 p.m. EST",15123,15560,13324,-1799
ISNE,"11/23/2022 8 p.m. EST",14744,15040,13076,-1668
ISNE,"11/23/2022 9 p.m. EST",14270,14420,12501,-1769
ISNE,"11/23/2022 10 p.m. EST",13586,13620,11644,-1942
ISNE,"11/23/2022 11 p.m. EST",12735,12640,10707,-2028
ISNE,"11/24/2022 12 a.m. EST",11896,11800,9890,-2006
ISNE,"11/24/2022 1 a.m. EST",11268,11270,9437,-1831
ISNE,"11/24/2022 2 a.m. EST",10931,10940,9271,-1660
ISNE,"11/24/2022 3 a.m. EST",11066,10780,9208,-1858
ISNE,"11/24/2022 4 a.m. EST",11077,10760,9307,-1770
ISNE,"11/24/2022 5 a.m. EST",10949,10970,9297,-1652
ISNE,"11/24/2022 6 a.m. EST",11427,11450,10071,-1356
ISNE,"11/24/2022 7 a.m. EST",12170,12210,10566,-1604
ISNE,"11/24/2022 8 a.m. EST",12779,12800,11124,-1655
ISNE,"11/24/2022 9 a.m. EST",12622,12620,11221,-1401
ISNE,"11/24/2022 10 a.m. EST",12082,12070,10932,-1150
ISNE,"11/24/2022 11 a.m. EST",11673,11660,10918,-755
ISNE,"11/24/2022 12 p.m. EST",11656,11430,10936,-720
ISNE,"11/24/2022 1 p.m. EST",11445,11180,10869,-576
ISNE,"11/24/2022 2 p.m. EST",11428,11290,10774,-654
ISNE,"11/24/2022 3 p.m. EST",11610,11670,10947,-663
ISNE,"11/24/2022 4 p.m. EST",12154,12120,11332,-822
ISNE,"11/24/2022 5 p.m. EST",12735,12780,11947,-788
ISNE,"11/24/2022 6 p.m. EST",12873,12970,11906,-967
ISNE,"11/24/2022 7 p.m. EST",12717,12820,11685,-1032
ISNE,"11/24/2022 8 p.m. EST",12612,12710,11508,-1104
ISNE,"11/24/2022 9 p.m. EST",12494,12550,11431,-1063
ISNE,"11/24/2022 10 p.m. EST",12165,12220,11258,-907
ISNE,"11/24/2022 11 p.m. EST",11657,11610,10876,-781
ISNE,"11/25/2022 12 a.m. EST",11062,10940,10233,-829
ISNE,"11/25/2022 1 a.m. EST",10567,10560,9443,-1124
ISNE,"11/25/2022 2 a.m. EST",10486,10230,9295,-1191
ISNE,"11/25/2022 3 a.m. EST",10859,10090,9653,-1206
ISNE,"11/25/2022 4 a.m. EST",10893,10060,9693,-1200
ISNE,"11/25/2022 5 a.m. EST",11108,10280,9875,-1233
ISNE,"11/25/2022 6 a.m. EST",11293,10750,10050,-1243
ISNE,"11/25/2022 7 a.m. EST",11419,11400,10301,-1118
ISNE,"11/25/2022 8 a.m. EST",11917,11950,10932,-985
ISNE,"11/25/2022 9 a.m. EST",12494,12520,11645,-849
ISNE,"11/25/2022 10 a.m. EST",12966,12960,12000,-966
ISNE,"11/25/2022 11 a.m. EST",13249,13100,12267,-982
ISNE,"11/25/2022 12 p.m. EST",13409,13120,12250,-1159
ISNE,"11/25/2022 1 p.m. EST",13478,13150,12079,-1399
ISNE,"11/25/2022 2 p.m. EST",13330,13160,11668,-1662
ISNE,"11/25/2022 3 p.m. EST",13093,13180,11452,-1641
ISNE,"11/25/2022 4 p.m. EST",13165,13430,11406,-1759
ISNE,"11/25/2022 5 p.m. EST",13850,14160,12244,-1606
ISNE,"11/25/2022 6 p.m. EST",14259,14650,12660,-1599
ISNE,"11/25/2022 7 p.m. EST",14010,14370,12280,-1730
ISNE,"11/25/2022 8 p.m. EST",13857,13920,12073,-1784
ISNE,"11/25/2022 9 p.m. EST",13467,13430,11730,-1737
ISNE,"11/25/2022 10 p.m. EST",12908,12820,11225,-1683
ISNE,"11/25/2022 11 p.m. EST",12196,12050,10651,-1545
ISNE,"11/26/2022 12 a.m. EST",11717,11290,10326,-1391
ISNE,"11/26/2022 1 a.m. EST",11206,10680,9966,-1240
ISNE,"11/26/2022 2 a.m. EST",10925,10350,9626,-1299
ISNE,"11/26/2022 3 a.m. EST",10980,10190,9805,-1175
ISNE,"11/26/2022 4 a.m. EST",10997,10170,9790,-1207
ISNE,"11/26/2022 5 a.m. EST",11139,10320,9916,-1223
ISNE,"11/26/2022 6 a.m. EST",11454,10690,10112,-1342
ISNE,"11/26/2022 7 a.m. EST",11773,11290,10734,-1039
ISNE,"11/26/2022 8 a.m. EST",12192,11700,11202,-990
ISNE,"11/26/2022 9 a.m. EST",11707,11450,10721,-986
ISNE,"11/26/2022 10 a.m. EST",11068,10690,9979,-1089
ISNE,"11/26/2022 11 a.m. EST",10924,10190,9873,-1051
ISNE,"11/26/2022 12 p.m. EST",10650,9800,9563,-1087
ISNE,"11/26/2022 1 p.m. EST",10818,9720,9685,-1133
ISNE,"11/26/2022 2 p.m. EST",11163,9890,10045,-1118
ISNE,"11/26/2022 3 p.m. EST",11572,10980,10449,-1123
ISNE,"11/26/2022 4 p.m. EST",12475,12160,11362,-1113
ISNE,"11/26/2022 5 p.m. EST",13320,13440,12193,-1127
ISNE,"11/26/2022 6 p.m. EST",13964,14230,12686,-1278
ISNE,"11/26/2022 7 p.m. EST",13781,14090,12597,-1184
ISNE,"11/26/2022 8 p.m. EST",13448,13650,12185,-1263
ISNE,"11/26/2022 9 p.m. EST",13028,13040,11868,-1160
ISNE,"11/26/2022 10 p.m. EST",12464,12460,11437,-1027
ISNE,"11/26/2022 11 p.m. EST",11743,11750,10722,-1021
ISNE,"11/27/2022 12 a.m. EST",11169,11070,10168,-1001
ISNE,"11/27/2022 1 a.m. EST",10621,10500,9549,-1072
ISNE,"11/27/2022 2 a.m. EST",10333,10160,9302,-1031
ISNE,"11/27/2022 3 a.m. EST",10296,10000,9351,-945
ISNE,"11/27/2022 4 a.m. EST",10256,9960,9284,-972
ISNE,"11/27/2022 5 a.m. EST",10348,10060,9378,-970
ISNE,"11/27/2022 6 a.m. EST",10620,10340,9728,-892
ISNE,"11/27/2022 7 a.m. EST",10888,10830,9983,-905
ISNE,"11/27/2022 8 a.m. EST",11479,11270,10581,-898
ISNE,"11/27/2022 9 a.m. EST",11793,11590,10816,-977
ISNE,"11/27/2022 10 a.m. EST",12059,11790,10952,-1107
ISNE,"11/27/2022 11 a.m. EST",12172,11900,11079,-1093
ISNE,"11/27/2022 12 p.m. EST",12326,12140,11307,-1019
ISNE,"11/27/2022 1 p.m. EST",12424,12320,11644,-780
ISNE,"11/27/2022 2 p.m. EST",12764,12550,11807,-957
ISNE,"11/27/2022 3 p.m. EST",13147,12790,12190,-957
ISNE,"11/27/2022 4 p.m. EST",13635,13260,12713,-922
ISNE,"11/27/2022 5 p.m. EST",14406,14250,12971,-1435
ISNE,"11/27/2022 6 p.m. EST",14730,14700,13174,-1556
ISNE,"11/27/2022 7 p.m. EST",14392,14340,12858,-1534
ISNE,"11/27/2022 8 p.m. EST",13858,13750,12210,-1648
ISNE,"11/27/2022 9 p.m. EST",13173,12980,11663,-1510
ISNE,"11/27/2022 10 p.m. EST",12333,12120,10956,-1377
ISNE,"11/27/2022 11 p.m. EST",11318,11200,10110,-1208
ISNE,"11/28/2022 12 a.m. EST",10703,10440,9410,-1293
ISNE,"11/28/2022 1 a.m. EST",10464,9900,9036,-1428
ISNE,"11/28/2022 2 a.m. EST",10175,9600,8959,-1216
ISNE,"11/28/2022 3 a.m. EST",10261,9470,9012,-1249
ISNE,"11/28/2022 4 a.m. EST",10319,9520,9105,-1214
ISNE,"11/28/2022 5 a.m. EST",10678,9910,9369,-1309
ISNE,"11/28/2022 6 a.m. EST",11478,10810,9983,-1495
ISNE,"11/28/2022 7 a.m. EST",12185,12240,10904,-1281
ISNE,"11/28/2022 8 a.m. EST",12968,13000,11652,-1316
ISNE,"11/28/2022 9 a.m. EST",12952,12990,11717,-1235
ISNE,"11/28/2022 10 a.m. EST",12796,12780,11657,-1139
ISNE,"11/28/2022 11 a.m. EST",12476,12740,11339,-1137
ISNE,"11/28/2022 12 p.m. EST",12276,12760,11103,-1173
ISNE,"11/28/2022 1 p.m. EST",12310,12820,11306,-1004
ISNE,"11/28/2022 2 p.m. EST",12524,12870,11538,-986
ISNE,"11/28/2022 3 p.m. EST",12825,13290,11666,-1159
ISNE,"11/28/2022 4 p.m. EST",13568,13900,12438,-1130
ISNE,"11/28/2022 5 p.m. EST",14703,14920,13564,-1139
ISNE,"11/28/2022 6 p.m. EST",15511,15700,14466,-1045
ISNE,"11/28/2022 7 p.m. EST",15359,15510,13950,-1409
ISNE,"11/28/2022 8 p.m. EST",14928,15000,13552,-1376
ISNE,"11/28/2022 9 p.m. EST",14336,14310,12760,-1576
ISNE,"11/28/2022 10 p.m. EST",13507,13480,11736,-1771
ISNE,"11/28/2022 11 p.m. EST",12493,12470,10750,-1743
ISNE,"11/29/2022 12 a.m. EST",11592,11610,9790,-1802
ISNE,"11/29/2022 1 a.m. EST",11503,11110,9531,-1972
ISNE,"11/29/2022 2 a.m. EST",11339,10820,9369,-1970
ISNE,"11/29/2022 3 a.m. EST",11459,10730,9655,-1804
ISNE,"11/29/2022 4 a.m. EST",11467,10810,9559,-1908
ISNE,"11/29/2022 5 a.m. EST",11714,11240,9826,-1888
ISNE,"11/29/2022 6 a.m. EST",12232,12210,10346,-1886
ISNE,"11/29/2022 7 a.m. EST",13712,13700,11949,-1763
ISNE,"11/29/2022 8 a.m. EST",14473,14410,12630,-1843
ISNE,"11/29/2022 9 a.m. EST",14027,13990,12096,-1931
ISNE,"11/29/2022 10 a.m. EST",13459,13310,11987,-1472
ISNE,"11/29/2022 11 a.m. EST",13196,12820,12164,-1032
ISNE,"11/29/2022 12 p.m. EST",12930,12690,11845,-1085
ISNE,"11/29/2022 1 p.m. EST",12825,12710,11721,-1104
ISNE,"11/29/2022 2 p.m. EST",13233,12930,12007,-1226
ISNE,"11/29/2022 3 p.m. EST",13442,13450,12329,-1113
ISNE,"11/29/2022 4 p.m. EST",14310,14230,12853,-1457
ISNE,"11/29/2022 5 p.m. EST",15470,15450,13881,-1589
ISNE,"11/29/2022 6 p.m. EST",16130,16250,14451,-1679
ISNE,"11/29/2022 7 p.m. EST",16017,15950,14456,-1561
ISNE,"11/29/2022 8 p.m. EST",15631,15470,14350,-1281
ISNE,"11/29/2022 9 p.m. EST",15013,14800,13574,-1439
ISNE,"11/29/2022 10 p.m. EST",14088,13920,12808,-1280
ISNE,"11/29/2022 11 p.m. EST",12980,12830,11522,-1458
ISNE,"11/30/2022 12 a.m. EST",12233,11940,10748,-1485
ISNE,"11/30/2022 1 a.m. EST",11619,11360,10048,-1571
ISNE,"11/30/2022 2 a.m. EST",11468,10980,9924,-1544
ISNE,"11/30/2022 3 a.m. EST",11573,10780,9871,-1702
ISNE,"11/30/2022 4 a.m. EST",11570,10760,9903,-1667
ISNE,"11/30/2022 5 a.m. EST",11864,11080,10276,-1588
ISNE,"11/30/2022 6 a.m. EST",12352,11950,10516,-1836
ISNE,"11/30/2022 7 a.m. EST",13342,13380,11543,-1799
ISNE,"11/30/2022 8 a.m. EST",14268,14310,12692,-1576
ISNE,"11/30/2022 9 a.m. EST",14590,14620,13109,-1481
ISNE,"11/30/2022 10 a.m. EST",14698,14650,13323,-1375
ISNE,"11/30/2022 11 a.m. EST",14680,14650,13464,-1216
ISNE,"11/30/2022 12 p.m. EST",14693,14620,13486,-1207
ISNE,"11/30/2022 1 p.m. EST",14723,14550,13567,-1156
ISNE,"11/30/2022 2 p.m. EST",14754,14550,13443,-1311
ISNE,"11/30/2022 3 p.m. EST",14732,14600,13556,-1176
ISNE,"11/30/2022 4 p.m. EST",14874,14730,13603,-1271
ISNE,"11/30/2022 5 p.m. EST",15466,15310,13992,-1474
ISNE,"11/30/2022 6 p.m. EST",15768,15750,14127,-1641
ISNE,"11/30/2022 7 p.m. EST",15413,15250,13730,-1683
ISNE,"11/30/2022 8 p.m. EST",14738,14700,12826,-1912
ISNE,"11/30/2022 9 p.m. EST",13994,14040,12026,-1968
ISNE,"11/30/2022 10 p.m. EST",13129,13200,11191,-1938
ISNE,"11/30/2022 11 p.m. EST",12148,12310,10405,-1743
ISNE,"12/1/2022 12 a.m. EST",11751,11490,9632,-2119
