"BA Code","Timestamp (Hour Ending)","Demand (MWh)","Demand Forecast (MWh)","Net Generation (MWh)","Total Interchange (MWh)"
ISNE,"6/1/2022 12 a.m. EDT",11825,11810,9719,-2106
ISNE,"6/1/2022 1 a.m. EDT",11204,10930,8683,-2521
ISNE,"6/1/2022 2 a.m. EDT",10951,10410,8367,-2584
ISNE,"6/1/2022 3 a.m. EDT",10879,10100,8447,-2432
ISNE,"6/1/2022 4 a.m. EDT",10784,9970,8416,-2368
ISNE,"6/1/2022 5 a.m. EDT",10937,10140,8490,-2447
ISNE,"6/1/2022 6 a.m. EDT",10937,10700,8726,-2211
ISNE,"6/1/2022 7 a.m. EDT",11670,11750,9599,-2071
ISNE,"6/1/2022 8 a.m. EDT",12448,12430,10343,-2105
ISNE,"6/1/2022 9 a.m. EDT",12638,12510,10706,-1932
ISNE,"6/1/2022 10 a.m. EDT",12606,12500,10739,-1867
ISNE,"6/1/2022 11 a.m. EDT",12655,12450,10711,-1944
ISNE,"6/1/2022 12 p.m. EDT",12754,12470,11051,-1703
ISNE,"6/1/2022 1 p.m. EDT",12707,12570,11294,-1413
ISNE,"6/1/2022 2 p.m. EDT",13018,12790,11840,-1178
ISNE,"6/1/2022 3 p.m. EDT",13253,12930,12023,-1230
ISNE,"6/1/2022 4 p.m. EDT",12997,13170,11645,-1352
ISNE,"6/1/2022 5 p.m. EDT",13182,13520,11923,-1259
ISNE,"6/1/2022 6 p.m. EDT",13485,13950,12034,-1451
ISNE,"6/1/2022 7 p.m. EDT",13667,14150,12219,-1448
ISNE,"6/1/2022 8 p.m. EDT",13618,14060,12110,-1508
ISNE,"6/1/2022 9 p.m. EDT",13485,13870,12131,-1354
ISNE,"6/1/2022 10 p.m. EDT",12833,13170,11382,-1451
ISNE,"6/1/2022 11 p.m. EDT",11740,12020,10100,-1640
ISNE,"6/2/2022 12 a.m. EDT",10730,10990,8959,-1771
ISNE,"6/2/2022 1 a.m. EDT",10271,10120,8582,-1689
ISNE,"6/2/2022 2 a.m. EDT",10507,9750,8739,-1768
ISNE,"6/2/2022 3 a.m. EDT",10340,9540,8520,-1820
ISNE,"6/2/2022 4 a.m. EDT",10302,9500,8416,-1886
ISNE,"6/2/2022 5 a.m. EDT",10441,9730,8621,-1820
ISNE,"6/2/2022 6 a.m. EDT",10584,10380,9098,-1486
ISNE,"6/2/2022 7 a.m. EDT",11491,11550,10186,-1305
ISNE,"6/2/2022 8 a.m. EDT",12394,12430,11125,-1269
ISNE,"6/2/2022 9 a.m. EDT",12666,12700,11298,-1368
ISNE,"6/2/2022 10 a.m. EDT",12607,12630,11237,-1370
ISNE,"6/2/2022 11 a.m. EDT",12355,12580,10964,-1391
ISNE,"6/2/2022 12 p.m. EDT",12084,12640,11000,-1084
ISNE,"6/2/2022 1 p.m. EDT",12486,12740,11471,-1015
ISNE,"6/2/2022 2 p.m. EDT",13056,13030,12480,-576
ISNE,"6/2/2022 3 p.m. EDT",13039,13030,12005,-1034
ISNE,"6/2/2022 4 p.m. EDT",13282,13330,12220,-1062
ISNE,"6/2/2022 5 p.m. EDT",13711,13960,12756,-955
ISNE,"6/2/2022 6 p.m. EDT",14046,14510,13017,-1029
ISNE,"6/2/2022 7 p.m. EDT",14068,14720,12965,-1103
ISNE,"6/2/2022 8 p.m. EDT",14002,14610,12677,-1325
ISNE,"6/2/2022 9 p.m. EDT",13956,14460,12619,-1337
ISNE,"6/2/2022 10 p.m. EDT",13362,13790,11920,-1442
ISNE,"6/2/2022 11 p.m. EDT",12265,12610,10777,-1488
ISNE,"6/3/2022 12 a.m. EDT",11255,11460,9688,-1567
ISNE,"6/3/2022 1 a.m. EDT",10896,10500,9350,-1546
ISNE,"6/3/2022 2 a.m. EDT",10847,10040,9186,-1661
ISNE,"6/3/2022 3 a.m. EDT",10589,9770,8852,-1737
ISNE,"6/3/2022 4 a.m. EDT",10488,9670,8714,-1774
ISNE,"6/3/2022 5 a.m. EDT",10660,9870,8947,-1713
ISNE,"6/3/2022 6 a.m. EDT",10987,10460,9493,-1494
ISNE,"6/3/2022 7 a.m. EDT",11555,11540,10384,-1171
ISNE,"6/3/2022 8 a.m. EDT",12439,12490,11408,-1031
ISNE,"6/3/2022 9 a.m. EDT",12925,12970,11883,-1042
ISNE,"6/3/2022 10 a.m. EDT",12993,12930,11986,-1007
ISNE,"6/3/2022 11 a.m. EDT",12861,12800,11902,-959
ISNE,"6/3/2022 12 p.m. EDT",12559,12380,11619,-940
ISNE,"6/3/2022 1 p.m. EDT",12291,12170,11280,-1011
ISNE,"6/3/2022 2 p.m. EDT",12189,12200,11067,-1122
ISNE,"6/3/2022 3 p.m. EDT",12228,12240,11194,-1034
ISNE,"6/3/2022 4 p.m. EDT",12459,12470,11340,-1119
ISNE,"6/3/2022 5 p.m. EDT",12908,12950,11851,-1057
ISNE,"6/3/2022 6 p.m. EDT",13578,13530,12497,-1081
ISNE,"6/3/2022 7 p.m. EDT",13996,13860,12649,-1347
ISNE,"6/3/2022 8 p.m. EDT",13944,13780,12046,-1898
ISNE,"6/3/2022 9 p.m. EDT",13792,13650,11851,-1941
ISNE,"6/3/2022 10 p.m. EDT",13257,13120,11547,-1710
ISNE,"6/3/2022 11 p.m. EDT",12285,12180,10472,-1813
ISNE,"6/4/2022 12 a.m. EDT",11303,11170,9574,-1729
ISNE,"6/4/2022 1 a.m. EDT",10538,10530,8914,-1624
ISNE,"6/4/2022 2 a.m. EDT",10613,9990,8790,-1823
ISNE,"6/4/2022 3 a.m. EDT",10361,9610,8935,-1426
ISNE,"6/4/2022 4 a.m. EDT",10004,9450,8594,-1410
ISNE,"6/4/2022 5 a.m. EDT",9999,9470,8557,-1442
ISNE,"6/4/2022 6 a.m. EDT",9914,9620,8526,-1388
ISNE,"6/4/2022 7 a.m. EDT",10249,9950,8483,-1766
ISNE,"6/4/2022 8 a.m. EDT",10396,10380,8739,-1657
ISNE,"6/4/2022 9 a.m. EDT",10652,10680,9164,-1488
ISNE,"6/4/2022 10 a.m. EDT",10590,10620,9472,-1118
ISNE,"6/4/2022 11 a.m. EDT",10292,10380,9373,-919
ISNE,"6/4/2022 12 p.m. EDT",10038,10190,9364,-674
ISNE,"6/4/2022 1 p.m. EDT",10090,10220,9523,-567
ISNE,"6/4/2022 2 p.m. EDT",10355,10340,9843,-512
ISNE,"6/4/2022 3 p.m. EDT",10683,10630,10094,-589
ISNE,"6/4/2022 4 p.m. EDT",11247,11180,10673,-574
ISNE,"6/4/2022 5 p.m. EDT",12013,12140,11382,-631
ISNE,"6/4/2022 6 p.m. EDT",12899,13000,11938,-961
ISNE,"6/4/2022 7 p.m. EDT",13553,13390,12555,-998
ISNE,"6/4/2022 8 p.m. EDT",13574,13250,12361,-1213
ISNE,"6/4/2022 9 p.m. EDT",13371,13130,12023,-1348
ISNE,"6/4/2022 10 p.m. EDT",12904,12620,11696,-1208
ISNE,"6/4/2022 11 p.m. EDT",11991,11650,10596,-1395
ISNE,"6/5/2022 12 a.m. EDT",10981,10670,9639,-1342
ISNE,"6/5/2022 1 a.m. EDT",10163,10180,9057,-1106
ISNE,"6/5/2022 2 a.m. EDT",9653,9650,8677,-976
ISNE,"6/5/2022 3 a.m. EDT",9619,9310,8632,-987
ISNE,"6/5/2022 4 a.m. EDT",9416,9110,8241,-1175
ISNE,"6/5/2022 5 a.m. EDT",9619,9050,8235,-1384
ISNE,"6/5/2022 6 a.m. EDT",9593,9030,8257,-1336
ISNE,"6/5/2022 7 a.m. EDT",9664,9100,8156,-1508
ISNE,"6/5/2022 8 a.m. EDT",9706,9130,8338,-1368
ISNE,"6/5/2022 9 a.m. EDT",9647,9080,8389,-1258
ISNE,"6/5/2022 10 a.m. EDT",9618,8950,8698,-920
ISNE,"6/5/2022 11 a.m. EDT",9738,8950,9118,-620
ISNE,"6/5/2022 12 p.m. EDT",9796,9030,9179,-617
ISNE,"6/5/2022 1 p.m. EDT",9776,9320,9174,-602
ISNE,"6/5/2022 2 p.m. EDT",9728,9580,9132,-596
ISNE,"6/5/2022 3 p.m. EDT",10064,9920,9567,-497
ISNE,"6/5/2022 4 p.m. EDT",10660,10520,10180,-480
ISNE,"6/5/2022 5 p.m. EDT",11513,11390,10912,-601
ISNE,"6/5/2022 6 p.m. EDT",12679,12510,11936,-743
ISNE,"6/5/2022 7 p.m. EDT",13505,13150,12490,-1015
ISNE,"6/5/2022 8 p.m. EDT",13670,13300,12448,-1222
ISNE,"6/5/2022 9 p.m. EDT",13525,13190,12116,-1409
ISNE,"6/5/2022 10 p.m. EDT",12981,12610,11370,-1611
ISNE,"6/5/2022 11 p.m. EDT",11860,11610,10294,-1566
ISNE,"6/6/2022 12 a.m. EDT",10962,10620,9386,-1576
ISNE,"6/6/2022 1 a.m. EDT",10728,10010,9418,-1310
ISNE,"6/6/2022 2 a.m. EDT",10288,9540,8952,-1336
ISNE,"6/6/2022 3 a.m. EDT",10345,9310,9032,-1313
ISNE,"6/6/2022 4 a.m. EDT",10312,9220,8999,-1313
ISNE,"6/6/2022 5 a.m. EDT",10529,9420,9019,-1510
ISNE,"6/6/2022 6 a.m. EDT",11094,9980,9184,-1910
ISNE,"6/6/2022 7 a.m. EDT",11573,11080,10055,-1518
ISNE,"6/6/2022 8 a.m. EDT",11611,11620,10312,-1299
ISNE,"6/6/2022 9 a.m. EDT",11501,11600,10416,-1085
ISNE,"6/6/2022 10 a.m. EDT",11278,11290,10511,-767
ISNE,"6/6/2022 11 a.m. EDT",11209,11230,10459,-750
ISNE,"6/6/2022 12 p.m. EDT",11364,11510,10713,-651
ISNE,"6/6/2022 1 p.m. EDT",11662,11960,11135,-527
ISNE,"6/6/2022 2 p.m. EDT",12261,12390,11721,-540
ISNE,"6/6/2022 3 p.m. EDT",12816,12780,12483,-333
ISNE,"6/6/2022 4 p.m. EDT",13434,13360,12767,-667
ISNE,"6/6/2022 5 p.m. EDT",14263,14070,13545,-718
ISNE,"6/6/2022 6 p.m. EDT",15063,14900,14252,-811
ISNE,"6/6/2022 7 p.m. EDT",15311,15200,13879,-1432
ISNE,"6/6/2022 8 p.m. EDT",15193,15040,13788,-1405
ISNE,"6/6/2022 9 p.m. EDT",14975,14800,13255,-1720
ISNE,"6/6/2022 10 p.m. EDT",14277,14010,12617,-1660
ISNE,"6/6/2022 11 p.m. EDT",13000,12740,11252,-1748
ISNE,"6/7/2022 12 a.m. EDT",11773,11560,9902,-1871
ISNE,"6/7/2022 1 a.m. EDT",11203,10590,9270,-1933
ISNE,"6/7/2022 2 a.m. EDT",10717,10080,8998,-1719
ISNE,"6/7/2022 3 a.m. EDT",10531,9810,8768,-1763
ISNE,"6/7/2022 4 a.m. EDT",10371,9670,8465,-1906
ISNE,"6/7/2022 5 a.m. EDT",10506,9880,8607,-1899
ISNE,"6/7/2022 6 a.m. EDT",10494,10480,8777,-1717
ISNE,"6/7/2022 7 a.m. EDT",11541,11600,9841,-1700
ISNE,"6/7/2022 8 a.m. EDT",12168,12190,10282,-1886
ISNE,"6/7/2022 9 a.m. EDT",12103,12100,10471,-1632
ISNE,"6/7/2022 10 a.m. EDT",11849,11870,10548,-1301
ISNE,"6/7/2022 11 a.m. EDT",11880,11820,10586,-1294
ISNE,"6/7/2022 12 p.m. EDT",12384,11990,11009,-1375
ISNE,"6/7/2022 1 p.m. EDT",12749,12200,11397,-1352
ISNE,"6/7/2022 2 p.m. EDT",13205,12590,11840,-1365
ISNE,"6/7/2022 3 p.m. EDT",13745,12850,12444,-1301
ISNE,"6/7/2022 4 p.m. EDT",14100,13400,12684,-1416
ISNE,"6/7/2022 5 p.m. EDT",14432,14340,12736,-1696
ISNE,"6/7/2022 6 p.m. EDT",15151,15060,13600,-1551
ISNE,"6/7/2022 7 p.m. EDT",15412,15500,13823,-1589
ISNE,"6/7/2022 8 p.m. EDT",15247,15220,13490,-1757
ISNE,"6/7/2022 9 p.m. EDT",15108,14920,13370,-1738
ISNE,"6/7/2022 10 p.m. EDT",14482,14250,12707,-1775
ISNE,"6/7/2022 11 p.m. EDT",13271,13020,11647,-1624
ISNE,"6/8/2022 12 a.m. EDT",12128,11880,10487,-1641
ISNE,"6/8/2022 1 a.m. EDT",11508,11230,9931,-1577
ISNE,"6/8/2022 2 a.m. EDT",11365,10720,9833,-1532
ISNE,"6/8/2022 3 a.m. EDT",11289,10470,9883,-1406
ISNE,"6/8/2022 4 a.m. EDT",11242,10340,9691,-1551
ISNE,"6/8/2022 5 a.m. EDT",11444,10540,9863,-1581
ISNE,"6/8/2022 6 a.m. EDT",11768,11180,10158,-1610
ISNE,"6/8/2022 7 a.m. EDT",12506,12380,11101,-1405
ISNE,"6/8/2022 8 a.m. EDT",13543,13400,12033,-1510
ISNE,"6/8/2022 9 a.m. EDT",13945,13890,12137,-1808
ISNE,"6/8/2022 10 a.m. EDT",13886,13880,12229,-1657
ISNE,"6/8/2022 11 a.m. EDT",13736,13630,12146,-1590
ISNE,"6/8/2022 12 p.m. EDT",13511,13570,12105,-1406
ISNE,"6/8/2022 1 p.m. EDT",13614,13730,12346,-1268
ISNE,"6/8/2022 2 p.m. EDT",13724,14140,12655,-1069
ISNE,"6/8/2022 3 p.m. EDT",13990,14630,12998,-992
ISNE,"6/8/2022 4 p.m. EDT",14417,15210,13497,-920
ISNE,"6/8/2022 5 p.m. EDT",15308,15610,14320,-988
ISNE,"6/8/2022 6 p.m. EDT",16254,16340,14851,-1403
ISNE,"6/8/2022 7 p.m. EDT",16681,16750,14910,-1771
ISNE,"6/8/2022 8 p.m. EDT",16445,16310,14502,-1943
ISNE,"6/8/2022 9 p.m. EDT",16072,16010,14131,-1941
ISNE,"6/8/2022 10 p.m. EDT",15312,15220,13868,-1444
ISNE,"6/8/2022 11 p.m. EDT",13963,13960,12568,-1395
ISNE,"6/9/2022 12 a.m. EDT",12662,12670,11296,-1366
ISNE,"6/9/2022 1 a.m. EDT",11852,11690,10417,-1435
ISNE,"6/9/2022 2 a.m. EDT",11337,11070,9889,-1448
ISNE,"6/9/2022 3 a.m. EDT",11375,10720,9885,-1490
ISNE,"6/9/2022 4 a.m. EDT",11345,10580,9943,-1402
ISNE,"6/9/2022 5 a.m. EDT",11496,10750,10246,-1250
ISNE,"6/9/2022 6 a.m. EDT",11709,11360,10524,-1185
ISNE,"6/9/2022 7 a.m. EDT",12539,12660,11198,-1341
ISNE,"6/9/2022 8 a.m. EDT",13633,13700,12179,-1454
ISNE,"6/9/2022 9 a.m. EDT",14335,14350,12922,-1413
ISNE,"6/9/2022 10 a.m. EDT",14550,14630,13341,-1209
ISNE,"6/9/2022 11 a.m. EDT",14439,14520,13079,-1360
ISNE,"6/9/2022 12 p.m. EDT",14456,14510,13291,-1165
ISNE,"6/9/2022 1 p.m. EDT",14511,14570,13462,-1049
ISNE,"6/9/2022 2 p.m. EDT",14759,14860,13610,-1149
ISNE,"6/9/2022 3 p.m. EDT",14811,15220,13526,-1285
ISNE,"6/9/2022 4 p.m. EDT",15117,15730,13845,-1272
ISNE,"6/9/2022 5 p.m. EDT",15587,16250,13961,-1626
ISNE,"6/9/2022 6 p.m. EDT",16157,16740,14274,-1883
ISNE,"6/9/2022 7 p.m. EDT",16317,16800,14285,-2032
ISNE,"6/9/2022 8 p.m. EDT",16007,16490,14116,-1891
ISNE,"6/9/2022 9 p.m. EDT",15498,15910,13589,-1909
ISNE,"6/9/2022 10 p.m. EDT",14814,15070,13096,-1718
ISNE,"6/9/2022 11 p.m. EDT",13545,13700,11653,-1892
ISNE,"6/10/2022 12 a.m. EDT",12235,12440,10362,-1873
ISNE,"6/10/2022 1 a.m. EDT",11229,11240,9740,-1489
ISNE,"6/10/2022 2 a.m. EDT",11254,10600,9764,-1490
ISNE,"6/10/2022 3 a.m. EDT",11006,10180,9493,-1513
ISNE,"6/10/2022 4 a.m. EDT",10802,9990,9350,-1452
ISNE,"6/10/2022 5 a.m. EDT",10902,10110,9504,-1398
ISNE,"6/10/2022 6 a.m. EDT",11101,10560,9435,-1666
ISNE,"6/10/2022 7 a.m. EDT",11947,11580,10218,-1729
ISNE,"6/10/2022 8 a.m. EDT",12093,12180,10433,-1660
ISNE,"6/10/2022 9 a.m. EDT",12036,12050,10403,-1633
ISNE,"6/10/2022 10 a.m. EDT",12080,11840,10335,-1745
ISNE,"6/10/2022 11 a.m. EDT",12172,11920,10639,-1533
ISNE,"6/10/2022 12 p.m. EDT",12204,12070,10834,-1370
ISNE,"6/10/2022 1 p.m. EDT",12426,12270,11214,-1212
ISNE,"6/10/2022 2 p.m. EDT",12675,12540,11356,-1319
ISNE,"6/10/2022 3 p.m. EDT",13085,12850,11746,-1339
ISNE,"6/10/2022 4 p.m. EDT",13468,13350,12167,-1301
ISNE,"6/10/2022 5 p.m. EDT",14175,14160,12456,-1719
ISNE,"6/10/2022 6 p.m. EDT",14828,14930,13117,-1711
ISNE,"6/10/2022 7 p.m. EDT",14869,15060,13224,-1645
ISNE,"6/10/2022 8 p.m. EDT",14639,14830,13080,-1559
ISNE,"6/10/2022 9 p.m. EDT",14437,14550,12700,-1737
ISNE,"6/10/2022 10 p.m. EDT",13964,14070,12417,-1547
ISNE,"6/10/2022 11 p.m. EDT",12963,12970,11312,-1651
ISNE,"6/11/2022 12 a.m. EDT",12111,11850,10445,-1666
ISNE,"6/11/2022 1 a.m. EDT",11119,11030,9358,-1761
ISNE,"6/11/2022 2 a.m. EDT",10367,10390,8918,-1449
ISNE,"6/11/2022 3 a.m. EDT",10285,9990,8845,-1440
ISNE,"6/11/2022 4 a.m. EDT",10075,9780,8661,-1414
ISNE,"6/11/2022 5 a.m. EDT",10037,9750,8652,-1385
ISNE,"6/11/2022 6 a.m. EDT",10109,9810,8672,-1437
ISNE,"6/11/2022 7 a.m. EDT",10313,10030,8866,-1447
ISNE,"6/11/2022 8 a.m. EDT",10595,10320,9271,-1324
ISNE,"6/11/2022 9 a.m. EDT",10773,10540,9426,-1347
ISNE,"6/11/2022 10 a.m. EDT",10763,10500,9462,-1301
ISNE,"6/11/2022 11 a.m. EDT",10762,10600,9526,-1236
ISNE,"6/11/2022 12 p.m. EDT",11040,10840,9857,-1183
ISNE,"6/11/2022 1 p.m. EDT",11236,11200,10073,-1163
ISNE,"6/11/2022 2 p.m. EDT",11658,11360,10379,-1279
ISNE,"6/11/2022 3 p.m. EDT",12026,12000,10747,-1279
ISNE,"6/11/2022 4 p.m. EDT",12178,12280,10914,-1264
ISNE,"6/11/2022 5 p.m. EDT",12485,12820,11180,-1305
ISNE,"6/11/2022 6 p.m. EDT",13204,13340,11935,-1269
ISNE,"6/11/2022 7 p.m. EDT",13724,13760,12415,-1309
ISNE,"6/11/2022 8 p.m. EDT",13784,13690,12326,-1458
ISNE,"6/11/2022 9 p.m. EDT",13689,13590,12261,-1428
ISNE,"6/11/2022 10 p.m. EDT",13328,13290,11932,-1396
ISNE,"6/11/2022 11 p.m. EDT",12468,12490,10809,-1659
ISNE,"6/12/2022 12 a.m. EDT",11524,11510,9745,-1779
ISNE,"6/12/2022 1 a.m. EDT",10724,10740,8927,-1797
ISNE,"6/12/2022 2 a.m. EDT",10146,10170,8269,-1877
ISNE,"6/12/2022 3 a.m. EDT",10113,9810,8211,-1902
ISNE,"6/12/2022 4 a.m. EDT",9893,9620,7930,-1963
ISNE,"6/12/2022 5 a.m. EDT",9840,9550,7829,-2011
ISNE,"6/12/2022 6 a.m. EDT",9772,9480,7940,-1832
ISNE,"6/12/2022 7 a.m. EDT",9911,9630,8329,-1582
ISNE,"6/12/2022 8 a.m. EDT",9799,9820,8532,-1267
ISNE,"6/12/2022 9 a.m. EDT",10065,10100,8904,-1161
ISNE,"6/12/2022 10 a.m. EDT",10378,10350,9389,-989
ISNE,"6/12/2022 11 a.m. EDT",10880,10900,10119,-761
ISNE,"6/12/2022 12 p.m. EDT",11354,11410,10357,-997
ISNE,"6/12/2022 1 p.m. EDT",11733,11960,10757,-976
ISNE,"6/12/2022 2 p.m. EDT",12087,12350,10718,-1369
ISNE,"6/12/2022 3 p.m. EDT",12313,12900,10993,-1320
ISNE,"6/12/2022 4 p.m. EDT",12777,13170,11555,-1222
ISNE,"6/12/2022 5 p.m. EDT",13600,13630,12156,-1444
ISNE,"6/12/2022 6 p.m. EDT",14139,14230,12648,-1491
ISNE,"6/12/2022 7 p.m. EDT",14530,14600,12840,-1690
ISNE,"6/12/2022 8 p.m. EDT",14560,14290,12776,-1784
ISNE,"6/12/2022 9 p.m. EDT",14501,14230,12838,-1663
ISNE,"6/12/2022 10 p.m. EDT",14032,13780,12373,-1659
ISNE,"6/12/2022 11 p.m. EDT",13038,12880,11093,-1945
ISNE,"6/13/2022 12 a.m. EDT",12059,11850,9720,-2339
ISNE,"6/13/2022 1 a.m. EDT",11590,11300,8864,-2726
ISNE,"6/13/2022 2 a.m. EDT",11511,10840,8506,-3005
ISNE,"6/13/2022 3 a.m. EDT",11405,10590,8476,-2929
ISNE,"6/13/2022 4 a.m. EDT",11340,10500,8527,-2813
ISNE,"6/13/2022 5 a.m. EDT",11489,10740,8573,-2916
ISNE,"6/13/2022 6 a.m. EDT",11661,11290,8943,-2718
ISNE,"6/13/2022 7 a.m. EDT",12570,12440,10220,-2350
ISNE,"6/13/2022 8 a.m. EDT",13462,13340,10996,-2466
ISNE,"6/13/2022 9 a.m. EDT",13759,13730,11317,-2442
ISNE,"6/13/2022 10 a.m. EDT",13856,13900,11836,-2020
ISNE,"6/13/2022 11 a.m. EDT",14113,14030,12313,-1800
ISNE,"6/13/2022 12 p.m. EDT",14412,14320,12929,-1483
ISNE,"6/13/2022 1 p.m. EDT",14756,14660,13546,-1210
ISNE,"6/13/2022 2 p.m. EDT",15131,15120,13883,-1248
ISNE,"6/13/2022 3 p.m. EDT",15425,15510,14289,-1136
ISNE,"6/13/2022 4 p.m. EDT",16027,15920,14850,-1177
ISNE,"6/13/2022 5 p.m. EDT",16870,16590,15921,-949
ISNE,"6/13/2022 6 p.m. EDT",17825,17460,17177,-648
ISNE,"6/13/2022 7 p.m. EDT",18262,17750,17137,-1125
ISNE,"6/13/2022 8 p.m. EDT",17928,17230,16783,-1145
ISNE,"6/13/2022 9 p.m. EDT",17238,16710,15573,-1665
ISNE,"6/13/2022 10 p.m. EDT",16253,15840,14411,-1842
ISNE,"6/13/2022 11 p.m. EDT",14676,14400,12722,-1954
ISNE,"6/14/2022 12 a.m. EDT",13506,13030,11191,-2315
ISNE,"6/14/2022 1 a.m. EDT",12429,11720,10301,-2128
ISNE,"6/14/2022 2 a.m. EDT",12104,11010,10030,-2074
ISNE,"6/14/2022 3 a.m. EDT",11732,10580,10114,-1618
ISNE,"6/14/2022 4 a.m. EDT",11622,10420,9911,-1711
ISNE,"6/14/2022 5 a.m. EDT",11653,10510,9812,-1841
ISNE,"6/14/2022 6 a.m. EDT",12062,10900,10296,-1766
ISNE,"6/14/2022 7 a.m. EDT",12574,11960,10959,-1615
ISNE,"6/14/2022 8 a.m. EDT",12868,12730,11704,-1164
ISNE,"6/14/2022 9 a.m. EDT",12552,12840,11594,-958
ISNE,"6/14/2022 10 a.m. EDT",12534,12530,11629,-905
ISNE,"6/14/2022 11 a.m. EDT",12578,12780,11657,-921
ISNE,"6/14/2022 12 p.m. EDT",12792,13140,11605,-1187
ISNE,"6/14/2022 1 p.m. EDT",13104,13250,11971,-1133
ISNE,"6/14/2022 2 p.m. EDT",13627,13370,12647,-980
ISNE,"6/14/2022 3 p.m. EDT",14261,14340,13237,-1024
ISNE,"6/14/2022 4 p.m. EDT",14966,15450,14009,-957
ISNE,"6/14/2022 5 p.m. EDT",15944,16510,14855,-1089
ISNE,"6/14/2022 6 p.m. EDT",16702,17490,15531,-1171
ISNE,"6/14/2022 7 p.m. EDT",17116,17800,15873,-1243
ISNE,"6/14/2022 8 p.m. EDT",16950,17330,15618,-1332
ISNE,"6/14/2022 9 p.m. EDT",16389,16730,14936,-1453
ISNE,"6/14/2022 10 p.m. EDT",15626,15970,14034,-1592
ISNE,"6/14/2022 11 p.m. EDT",14238,14560,12413,-1825
ISNE,"6/15/2022 12 a.m. EDT",12866,13200,10794,-2072
ISNE,"6/15/2022 1 a.m. EDT",12134,11950,9773,-2361
ISNE,"6/15/2022 2 a.m. EDT",11713,11230,9512,-2201
ISNE,"6/15/2022 3 a.m. EDT",11547,10790,9186,-2361
ISNE,"6/15/2022 4 a.m. EDT",11333,10600,8820,-2513
ISNE,"6/15/2022 5 a.m. EDT",11429,10690,8870,-2559
ISNE,"6/15/2022 6 a.m. EDT",11679,11190,9189,-2490
ISNE,"6/15/2022 7 a.m. EDT",12485,12170,9912,-2573
ISNE,"6/15/2022 8 a.m. EDT",13099,12870,11159,-1940
ISNE,"6/15/2022 9 a.m. EDT",12863,12880,11068,-1795
ISNE,"6/15/2022 10 a.m. EDT",12788,12770,11360,-1428
ISNE,"6/15/2022 11 a.m. EDT",12834,13070,11689,-1145
ISNE,"6/15/2022 12 p.m. EDT",13039,13440,11999,-1040
ISNE,"6/15/2022 1 p.m. EDT",13262,13260,12244,-1018
ISNE,"6/15/2022 2 p.m. EDT",13564,13780,12678,-886
ISNE,"6/15/2022 3 p.m. EDT",13983,14300,13189,-794
ISNE,"6/15/2022 4 p.m. EDT",14640,14990,13789,-851
ISNE,"6/15/2022 5 p.m. EDT",15423,15530,14712,-711
ISNE,"6/15/2022 6 p.m. EDT",16177,16330,15124,-1053
ISNE,"6/15/2022 7 p.m. EDT",16396,16680,15205,-1191
ISNE,"6/15/2022 8 p.m. EDT",16030,16430,14634,-1396
ISNE,"6/15/2022 9 p.m. EDT",15675,16050,14392,-1283
ISNE,"6/15/2022 10 p.m. EDT",15017,15180,13460,-1557
ISNE,"6/15/2022 11 p.m. EDT",13734,13810,12178,-1556
ISNE,"6/16/2022 12 a.m. EDT",12438,12510,10823,-1615
ISNE,"6/16/2022 1 a.m. EDT",11733,11510,9596,-2137
ISNE,"6/16/2022 2 a.m. EDT",11175,10890,8980,-2195
ISNE,"6/16/2022 3 a.m. EDT",10810,10530,8573,-2237
ISNE,"6/16/2022 4 a.m. EDT",10906,10380,8454,-2452
ISNE,"6/16/2022 5 a.m. EDT",10811,10530,8369,-2442
ISNE,"6/16/2022 6 a.m. EDT",11248,10990,8840,-2408
ISNE,"6/16/2022 7 a.m. EDT",12105,12040,9518,-2587
ISNE,"6/16/2022 8 a.m. EDT",12729,12780,10851,-1878
ISNE,"6/16/2022 9 a.m. EDT",12998,13050,11335,-1663
ISNE,"6/16/2022 10 a.m. EDT",13113,13170,11538,-1575
ISNE,"6/16/2022 11 a.m. EDT",13572,13080,12368,-1204
ISNE,"6/16/2022 12 p.m. EDT",13492,13180,12163,-1329
ISNE,"6/16/2022 1 p.m. EDT",13380,13280,12303,-1077
ISNE,"6/16/2022 2 p.m. EDT",13614,13630,12544,-1070
ISNE,"6/16/2022 3 p.m. EDT",13743,13890,12711,-1032
ISNE,"6/16/2022 4 p.m. EDT",13716,14150,12729,-987
ISNE,"6/16/2022 5 p.m. EDT",14029,14570,12984,-1045
ISNE,"6/16/2022 6 p.m. EDT",14491,15040,13253,-1238
ISNE,"6/16/2022 7 p.m. EDT",14789,15670,13317,-1472
ISNE,"6/16/2022 8 p.m. EDT",14756,15540,12967,-1789
ISNE,"6/16/2022 9 p.m. EDT",14647,15090,12950,-1697
ISNE,"6/16/2022 10 p.m. EDT",14112,14470,12220,-1892
ISNE,"6/16/2022 11 p.m. EDT",13132,13440,11201,-1931
ISNE,"6/17/2022 12 a.m. EDT",12130,12320,10034,-2096
ISNE,"6/17/2022 1 a.m. EDT",11425,11480,9206,-2219
ISNE,"6/17/2022 2 a.m. EDT",11497,10970,8947,-2550
ISNE,"6/17/2022 3 a.m. EDT",11456,10760,8912,-2544
ISNE,"6/17/2022 4 a.m. EDT",11381,10650,8832,-2549
ISNE,"6/17/2022 5 a.m. EDT",11562,10880,8971,-2591
ISNE,"6/17/2022 6 a.m. EDT",11723,11460,9314,-2409
ISNE,"6/17/2022 7 a.m. EDT",12429,12520,9988,-2441
ISNE,"6/17/2022 8 a.m. EDT",13478,13410,11084,-2394
ISNE,"6/17/2022 9 a.m. EDT",14175,13820,12198,-1977
ISNE,"6/17/2022 10 a.m. EDT",14408,14070,12285,-2123
ISNE,"6/17/2022 11 a.m. EDT",14579,14430,12611,-1968
ISNE,"6/17/2022 12 p.m. EDT",14763,14840,13166,-1597
ISNE,"6/17/2022 1 p.m. EDT",15425,15540,13713,-1712
ISNE,"6/17/2022 2 p.m. EDT",16241,15830,14964,-1277
ISNE,"6/17/2022 3 p.m. EDT",16113,16320,14692,-1421
ISNE,"6/17/2022 4 p.m. EDT",16180,16860,14840,-1340
ISNE,"6/17/2022 5 p.m. EDT",16604,17360,15335,-1269
ISNE,"6/17/2022 6 p.m. EDT",17095,17890,15713,-1382
ISNE,"6/17/2022 7 p.m. EDT",17275,18000,15771,-1504
ISNE,"6/17/2022 8 p.m. EDT",16990,17440,15157,-1833
ISNE,"6/17/2022 9 p.m. EDT",16351,17020,14193,-2158
ISNE,"6/17/2022 10 p.m. EDT",15693,16350,13460,-2233
ISNE,"6/17/2022 11 p.m. EDT",14456,14860,12409,-2047
ISNE,"6/18/2022 12 a.m. EDT",13118,13460,11322,-1796
ISNE,"6/18/2022 1 a.m. EDT",12067,12080,10206,-1861
ISNE,"6/18/2022 2 a.m. EDT",11353,11370,9770,-1583
ISNE,"6/18/2022 3 a.m. EDT",10892,10910,9594,-1298
ISNE,"6/18/2022 4 a.m. EDT",10619,10640,9334,-1285
ISNE,"6/18/2022 5 a.m. EDT",10848,10550,9432,-1416
ISNE,"6/18/2022 6 a.m. EDT",10843,10550,9407,-1436
ISNE,"6/18/2022 7 a.m. EDT",11067,10780,9540,-1527
ISNE,"6/18/2022 8 a.m. EDT",10979,11030,9652,-1327
ISNE,"6/18/2022 9 a.m. EDT",11175,11430,9816,-1359
ISNE,"6/18/2022 10 a.m. EDT",11005,10980,9826,-1179
ISNE,"6/18/2022 11 a.m. EDT",10967,10880,9808,-1159
ISNE,"6/18/2022 12 p.m. EDT",11024,10870,9891,-1133
ISNE,"6/18/2022 1 p.m. EDT",11098,10950,10000,-1098
ISNE,"6/18/2022 2 p.m. EDT",11211,11040,10060,-1151
ISNE,"6/18/2022 3 p.m. EDT",11349,11120,10063,-1286
ISNE,"6/18/2022 4 p.m. EDT",11677,11370,10404,-1273
ISNE,"6/18/2022 5 p.m. EDT",11965,11910,10670,-1295
ISNE,"6/18/2022 6 p.m. EDT",12307,12560,10857,-1450
ISNE,"6/18/2022 7 p.m. EDT",12406,12950,10985,-1421
ISNE,"6/18/2022 8 p.m. EDT",12339,13000,10953,-1386
ISNE,"6/18/2022 9 p.m. EDT",12298,12740,11080,-1218
ISNE,"6/18/2022 10 p.m. EDT",11920,12400,11143,-777
ISNE,"6/18/2022 11 p.m. EDT",11188,11560,11098,-90
ISNE,"6/19/2022 12 a.m. EDT",10403,10710,10280,-123
ISNE,"6/19/2022 1 a.m. EDT",9896,9790,9743,-153
ISNE,"6/19/2022 2 a.m. EDT",9625,9370,9216,-409
ISNE,"6/19/2022 3 a.m. EDT",9382,9130,8979,-403
ISNE,"6/19/2022 4 a.m. EDT",9415,9010,8981,-434
ISNE,"6/19/2022 5 a.m. EDT",9307,9000,8895,-412
ISNE,"6/19/2022 6 a.m. EDT",9367,9050,8947,-420
ISNE,"6/19/2022 7 a.m. EDT",9276,9200,8823,-453
ISNE,"6/19/2022 8 a.m. EDT",9471,9400,9131,-340
ISNE,"6/19/2022 9 a.m. EDT",9763,9500,9556,-207
ISNE,"6/19/2022 10 a.m. EDT",9475,9130,9181,-294
ISNE,"6/19/2022 11 a.m. EDT",9463,9020,9013,-450
ISNE,"6/19/2022 12 p.m. EDT",9703,8990,9121,-582
ISNE,"6/19/2022 1 p.m. EDT",9974,8930,9204,-770
ISNE,"6/19/2022 2 p.m. EDT",10056,9010,8704,-1352
ISNE,"6/19/2022 3 p.m. EDT",10224,9260,8952,-1272
ISNE,"6/19/2022 4 p.m. EDT",10312,9680,9228,-1084
ISNE,"6/19/2022 5 p.m. EDT",10951,10800,10088,-863
ISNE,"6/19/2022 6 p.m. EDT",11584,11370,10478,-1106
ISNE,"6/19/2022 7 p.m. EDT",11960,12110,11005,-955
ISNE,"6/19/2022 8 p.m. EDT",12103,12500,11001,-1102
ISNE,"6/19/2022 9 p.m. EDT",12176,12420,10856,-1320
ISNE,"6/19/2022 10 p.m. EDT",11909,12050,10519,-1390
ISNE,"6/19/2022 11 p.m. EDT",11100,11150,9620,-1480
ISNE,"6/20/2022 12 a.m. EDT",10243,10250,8549,-1694
ISNE,"6/20/2022 1 a.m. EDT",9613,9850,7880,-1733
ISNE,"6/20/2022 2 a.m. EDT",9407,9360,7701,-1706
ISNE,"6/20/2022 3 a.m. EDT",9352,9090,7644,-1708
ISNE,"6/20/2022 4 a.m. EDT",9546,9030,7640,-1906
ISNE,"6/20/2022 5 a.m. EDT",9438,9230,7545,-1893
ISNE,"6/20/2022 6 a.m. EDT",9658,9600,7901,-1757
ISNE,"6/20/2022 7 a.m. EDT",10424,10310,8768,-1656
ISNE,"6/20/2022 8 a.m. EDT",10809,10550,9197,-1612
ISNE,"6/20/2022 9 a.m. EDT",10759,10480,8982,-1777
ISNE,"6/20/2022 10 a.m. EDT",10511,10490,9145,-1366
ISNE,"6/20/2022 11 a.m. EDT",10421,10400,9321,-1100
ISNE,"6/20/2022 12 p.m. EDT",10477,10260,9608,-869
ISNE,"6/20/2022 1 p.m. EDT",10547,10350,9816,-731
ISNE,"6/20/2022 2 p.m. EDT",10762,10850,10204,-558
ISNE,"6/20/2022 3 p.m. EDT",11091,11120,10419,-672
ISNE,"6/20/2022 4 p.m. EDT",11662,11540,11101,-561
ISNE,"6/20/2022 5 p.m. EDT",12615,12270,11871,-744
ISNE,"6/20/2022 6 p.m. EDT",13756,13360,13164,-592
ISNE,"6/20/2022 7 p.m. EDT",14428,13870,13535,-893
ISNE,"6/20/2022 8 p.m. EDT",14389,14000,13320,-1069
ISNE,"6/20/2022 9 p.m. EDT",14123,13840,12602,-1521
ISNE,"6/20/2022 10 p.m. EDT",13575,13280,12051,-1524
ISNE,"6/20/2022 11 p.m. EDT",12419,12200,10411,-2008
ISNE,"6/21/2022 12 a.m. EDT",11279,11060,9157,-2122
ISNE,"6/21/2022 1 a.m. EDT",10447,10470,8516,-1931
ISNE,"6/21/2022 2 a.m. EDT",10186,9930,8245,-1941
ISNE,"6/21/2022 3 a.m. EDT",9951,9630,8124,-1827
ISNE,"6/21/2022 4 a.m. EDT",10054,9500,8068,-1986
ISNE,"6/21/2022 5 a.m. EDT",10033,9690,8050,-1983
ISNE,"6/21/2022 6 a.m. EDT",10428,10140,8495,-1933
ISNE,"6/21/2022 7 a.m. EDT",11161,11000,9450,-1711
ISNE,"6/21/2022 8 a.m. EDT",11570,11610,10327,-1243
ISNE,"6/21/2022 9 a.m. EDT",11663,11710,10521,-1142
ISNE,"6/21/2022 10 a.m. EDT",11589,11500,10764,-825
ISNE,"6/21/2022 11 a.m. EDT",11791,11530,10921,-870
ISNE,"6/21/2022 12 p.m. EDT",12151,11650,11218,-933
ISNE,"6/21/2022 1 p.m. EDT",12507,11800,11551,-956
ISNE,"6/21/2022 2 p.m. EDT",12440,12110,11456,-984
ISNE,"6/21/2022 3 p.m. EDT",12540,12370,11376,-1164
ISNE,"6/21/2022 4 p.m. EDT",13009,12900,12210,-799
ISNE,"6/21/2022 5 p.m. EDT",13628,13730,12716,-912
ISNE,"6/21/2022 6 p.m. EDT",14401,14550,13260,-1141
ISNE,"6/21/2022 7 p.m. EDT",14740,14950,13452,-1288
ISNE,"6/21/2022 8 p.m. EDT",14582,14850,13166,-1416
ISNE,"6/21/2022 9 p.m. EDT",14309,14520,12730,-1579
ISNE,"6/21/2022 10 p.m. EDT",13749,13860,11980,-1769
ISNE,"6/21/2022 11 p.m. EDT",12655,12730,11161,-1494
ISNE,"6/22/2022 12 a.m. EDT",11552,11600,10102,-1450
ISNE,"6/22/2022 1 a.m. EDT",10926,10810,9401,-1525
ISNE,"6/22/2022 2 a.m. EDT",11139,10340,9398,-1741
ISNE,"6/22/2022 3 a.m. EDT",10883,10070,9033,-1850
ISNE,"6/22/2022 4 a.m. EDT",11025,9980,9118,-1907
ISNE,"6/22/2022 5 a.m. EDT",10995,10180,9042,-1953
ISNE,"6/22/2022 6 a.m. EDT",11249,10730,9488,-1761
ISNE,"6/22/2022 7 a.m. EDT",12244,11730,10619,-1625
ISNE,"6/22/2022 8 a.m. EDT",12945,12690,11492,-1453
ISNE,"6/22/2022 9 a.m. EDT",13304,13120,11890,-1414
ISNE,"6/22/2022 10 a.m. EDT",13177,13180,12028,-1149
ISNE,"6/22/2022 11 a.m. EDT",13246,13150,12267,-979
ISNE,"6/22/2022 12 p.m. EDT",13322,13140,12588,-734
ISNE,"6/22/2022 1 p.m. EDT",13288,13260,12673,-615
ISNE,"6/22/2022 2 p.m. EDT",13163,13270,12163,-1000
ISNE,"6/22/2022 3 p.m. EDT",13094,13250,11840,-1254
ISNE,"6/22/2022 4 p.m. EDT",13104,13400,11925,-1179
ISNE,"6/22/2022 5 p.m. EDT",13422,13630,12193,-1229
ISNE,"6/22/2022 6 p.m. EDT",13924,14160,12647,-1277
ISNE,"6/22/2022 7 p.m. EDT",14229,14600,12692,-1537
ISNE,"6/22/2022 8 p.m. EDT",14143,14350,12534,-1609
ISNE,"6/22/2022 9 p.m. EDT",13969,14110,12123,-1846
ISNE,"6/22/2022 10 p.m. EDT",13500,13570,11705,-1795
ISNE,"6/22/2022 11 p.m. EDT",12466,12510,10692,-1774
ISNE,"6/23/2022 12 a.m. EDT",11423,11470,9593,-1830
ISNE,"6/23/2022 1 a.m. EDT",11261,10730,8917,-2344
ISNE,"6/23/2022 2 a.m. EDT",11035,10230,8734,-2301
ISNE,"6/23/2022 3 a.m. EDT",10924,9980,8601,-2323
ISNE,"6/23/2022 4 a.m. EDT",10919,9850,8667,-2252
ISNE,"6/23/2022 5 a.m. EDT",10869,10040,8713,-2156
ISNE,"6/23/2022 6 a.m. EDT",11170,10600,8641,-2529
ISNE,"6/23/2022 7 a.m. EDT",11581,11690,9432,-2149
ISNE,"6/23/2022 8 a.m. EDT",12181,12440,10031,-2150
ISNE,"6/23/2022 9 a.m. EDT",12485,12610,10695,-1790
ISNE,"6/23/2022 10 a.m. EDT",12463,12520,11330,-1133
ISNE,"6/23/2022 11 a.m. EDT",12618,12630,11599,-1019
ISNE,"6/23/2022 12 p.m. EDT",13041,12690,11865,-1176
ISNE,"6/23/2022 1 p.m. EDT",13104,13020,12108,-996
ISNE,"6/23/2022 2 p.m. EDT",13369,13250,12186,-1183
ISNE,"6/23/2022 3 p.m. EDT",13466,13450,12284,-1182
ISNE,"6/23/2022 4 p.m. EDT",13622,13780,12637,-985
ISNE,"6/23/2022 5 p.m. EDT",14097,14270,13150,-947
ISNE,"6/23/2022 6 p.m. EDT",14908,14660,13650,-1258
ISNE,"6/23/2022 7 p.m. EDT",15146,15000,13719,-1427
ISNE,"6/23/2022 8 p.m. EDT",14912,14780,13188,-1724
ISNE,"6/23/2022 9 p.m. EDT",14624,14420,12967,-1657
ISNE,"6/23/2022 10 p.m. EDT",14116,13920,12617,-1499
ISNE,"6/23/2022 11 p.m. EDT",13012,12790,11547,-1465
ISNE,"6/24/2022 12 a.m. EDT",11870,11680,10316,-1554
ISNE,"6/24/2022 1 a.m. EDT",11022,11050,9524,-1498
ISNE,"6/24/2022 2 a.m. EDT",10877,10520,9147,-1730
ISNE,"6/24/2022 3 a.m. EDT",10708,10180,8856,-1852
ISNE,"6/24/2022 4 a.m. EDT",10583,10050,8726,-1857
ISNE,"6/24/2022 5 a.m. EDT",10719,10140,8992,-1727
ISNE,"6/24/2022 6 a.m. EDT",11137,10580,9314,-1823
ISNE,"6/24/2022 7 a.m. EDT",11595,11540,10057,-1538
ISNE,"6/24/2022 8 a.m. EDT",12132,12260,10632,-1500
ISNE,"6/24/2022 9 a.m. EDT",12334,12660,10745,-1589
ISNE,"6/24/2022 10 a.m. EDT",12235,12380,11047,-1188
ISNE,"6/24/2022 11 a.m. EDT",12544,12500,11350,-1194
ISNE,"6/24/2022 12 p.m. EDT",13102,13130,11997,-1105
ISNE,"6/24/2022 1 p.m. EDT",13365,13480,12148,-1217
ISNE,"6/24/2022 2 p.m. EDT",13778,13890,12498,-1280
ISNE,"6/24/2022 3 p.m. EDT",14232,14150,13094,-1138
ISNE,"6/24/2022 4 p.m. EDT",14841,14650,13634,-1207
ISNE,"6/24/2022 5 p.m. EDT",15417,15160,13980,-1437
ISNE,"6/24/2022 6 p.m. EDT",16107,15560,14508,-1599
ISNE,"6/24/2022 7 p.m. EDT",16467,15900,14611,-1856
ISNE,"6/24/2022 8 p.m. EDT",16360,15510,14171,-2189
ISNE,"6/24/2022 9 p.m. EDT",15933,15310,13405,-2528
ISNE,"6/24/2022 10 p.m. EDT",15415,14830,13207,-2208
ISNE,"6/24/2022 11 p.m. EDT",14344,13730,12600,-1744
ISNE,"6/25/2022 12 a.m. EDT",13278,12630,11587,-1691
ISNE,"6/25/2022 1 a.m. EDT",12514,12170,10294,-2220
ISNE,"6/25/2022 2 a.m. EDT",12046,11390,9435,-2611
ISNE,"6/25/2022 3 a.m. EDT",11656,10930,9108,-2548
ISNE,"6/25/2022 4 a.m. EDT",11525,10630,9179,-2346
ISNE,"6/25/2022 5 a.m. EDT",11578,10600,9387,-2191
ISNE,"6/25/2022 6 a.m. EDT",11679,10490,9636,-2043
ISNE,"6/25/2022 7 a.m. EDT",12040,10960,10066,-1974
ISNE,"6/25/2022 8 a.m. EDT",12214,11480,10445,-1769
ISNE,"6/25/2022 9 a.m. EDT",12570,11890,10924,-1646
ISNE,"6/25/2022 10 a.m. EDT",12623,12480,11348,-1275
ISNE,"6/25/2022 11 a.m. EDT",12705,13190,11789,-916
ISNE,"6/25/2022 12 p.m. EDT",13255,13810,12577,-678
ISNE,"6/25/2022 1 p.m. EDT",13839,14590,13207,-632
ISNE,"6/25/2022 2 p.m. EDT",14386,15360,13990,-396
ISNE,"6/25/2022 3 p.m. EDT",15014,16090,14496,-518
ISNE,"6/25/2022 4 p.m. EDT",15845,16940,15010,-835
ISNE,"6/25/2022 5 p.m. EDT",16881,18020,15986,-895
ISNE,"6/25/2022 6 p.m. EDT",17840,18860,16950,-890
ISNE,"6/25/2022 7 p.m. EDT",18404,19270,17521,-883
ISNE,"6/25/2022 8 p.m. EDT",18217,18330,17150,-1067
ISNE,"6/25/2022 9 p.m. EDT",17561,17980,16369,-1192
ISNE,"6/25/2022 10 p.m. EDT",16858,17130,15274,-1584
ISNE,"6/25/2022 11 p.m. EDT",15646,15760,14012,-1634
ISNE,"6/26/2022 12 a.m. EDT",14334,14460,12252,-2082
ISNE,"6/26/2022 1 a.m. EDT",13271,13210,11023,-2248
ISNE,"6/26/2022 2 a.m. EDT",12999,12320,10616,-2383
ISNE,"6/26/2022 3 a.m. EDT",12712,11840,10640,-2072
ISNE,"6/26/2022 4 a.m. EDT",12564,11380,10655,-1909
ISNE,"6/26/2022 5 a.m. EDT",12367,11280,10415,-1952
ISNE,"6/26/2022 6 a.m. EDT",12226,11160,10317,-1909
ISNE,"6/26/2022 7 a.m. EDT",12421,11310,10536,-1885
ISNE,"6/26/2022 8 a.m. EDT",12529,11940,11077,-1452
ISNE,"6/26/2022 9 a.m. EDT",12634,12340,11419,-1215
ISNE,"6/26/2022 10 a.m. EDT",13158,12980,12192,-966
ISNE,"6/26/2022 11 a.m. EDT",13997,13830,12918,-1079
ISNE,"6/26/2022 12 p.m. EDT",14852,15040,14065,-787
ISNE,"6/26/2022 1 p.m. EDT",15836,15990,14997,-839
ISNE,"6/26/2022 2 p.m. EDT",16512,16840,15494,-1018
ISNE,"6/26/2022 3 p.m. EDT",16891,17360,15871,-1020
ISNE,"6/26/2022 4 p.m. EDT",17558,18310,16546,-1012
ISNE,"6/26/2022 5 p.m. EDT",18348,19160,17370,-978
ISNE,"6/26/2022 6 p.m. EDT",19242,20060,18405,-837
ISNE,"6/26/2022 7 p.m. EDT",19597,20300,18537,-1060
ISNE,"6/26/2022 8 p.m. EDT",19210,19700,18237,-973
ISNE,"6/26/2022 9 p.m. EDT",18558,18760,17093,-1465
ISNE,"6/26/2022 10 p.m. EDT",17741,17800,16046,-1695
ISNE,"6/26/2022 11 p.m. EDT",16235,16150,14601,-1634
ISNE,"6/27/2022 12 a.m. EDT",14723,14740,12946,-1777
ISNE,"6/27/2022 1 a.m. EDT",13851,13560,11704,-2147
ISNE,"6/27/2022 2 a.m. EDT",13269,12800,11116,-2153
ISNE,"6/27/2022 3 a.m. EDT",12895,12360,10563,-2332
ISNE,"6/27/2022 4 a.m. EDT",12856,12160,10586,-2270
ISNE,"6/27/2022 5 a.m. EDT",12977,12320,10824,-2153
ISNE,"6/27/2022 6 a.m. EDT",13365,12850,11156,-2209
ISNE,"6/27/2022 7 a.m. EDT",14156,13900,12157,-1999
ISNE,"6/27/2022 8 a.m. EDT",14890,14950,13056,-1834
ISNE,"6/27/2022 9 a.m. EDT",15677,15740,13719,-1958
ISNE,"6/27/2022 10 a.m. EDT",16231,16250,13994,-2237
ISNE,"6/27/2022 11 a.m. EDT",16494,16540,14051,-2443
ISNE,"6/27/2022 12 p.m. EDT",16739,16740,14362,-2377
ISNE,"6/27/2022 1 p.m. EDT",16800,16930,14462,-2338
ISNE,"6/27/2022 2 p.m. EDT",16745,17000,14468,-2277
ISNE,"6/27/2022 3 p.m. EDT",16552,16960,14480,-2072
ISNE,"6/27/2022 4 p.m. EDT",16348,17010,14614,-1734
ISNE,"6/27/2022 5 p.m. EDT",16502,17040,14696,-1806
ISNE,"6/27/2022 6 p.m. EDT",16903,17190,14984,-1919
ISNE,"6/27/2022 7 p.m. EDT",16846,17220,14734,-2112
ISNE,"6/27/2022 8 p.m. EDT",16552,17140,14461,-2091
ISNE,"6/27/2022 9 p.m. EDT",16144,16650,14393,-1751
ISNE,"6/27/2022 10 p.m. EDT",15523,15840,13797,-1726
ISNE,"6/27/2022 11 p.m. EDT",14253,14520,12529,-1724
ISNE,"6/28/2022 12 a.m. EDT",13007,13230,11350,-1657
ISNE,"6/28/2022 1 a.m. EDT",12467,11920,10763,-1704
ISNE,"6/28/2022 2 a.m. EDT",11959,11180,10535,-1424
ISNE,"6/28/2022 3 a.m. EDT",11525,10710,9918,-1607
ISNE,"6/28/2022 4 a.m. EDT",11276,10470,9585,-1691
ISNE,"6/28/2022 5 a.m. EDT",11323,10550,9785,-1538
ISNE,"6/28/2022 6 a.m. EDT",11760,10990,10020,-1740
ISNE,"6/28/2022 7 a.m. EDT",12321,11850,10394,-1927
ISNE,"6/28/2022 8 a.m. EDT",12708,12520,10789,-1919
ISNE,"6/28/2022 9 a.m. EDT",12778,12590,10865,-1913
ISNE,"6/28/2022 10 a.m. EDT",12644,12400,11019,-1625
ISNE,"6/28/2022 11 a.m. EDT",12757,12260,11347,-1410
ISNE,"6/28/2022 12 p.m. EDT",13238,12430,11765,-1473
ISNE,"6/28/2022 1 p.m. EDT",13590,12810,12157,-1433
ISNE,"6/28/2022 2 p.m. EDT",13805,13380,12352,-1453
ISNE,"6/28/2022 3 p.m. EDT",14069,13940,12743,-1326
ISNE,"6/28/2022 4 p.m. EDT",14411,14620,13072,-1339
ISNE,"6/28/2022 5 p.m. EDT",15208,15490,14009,-1199
ISNE,"6/28/2022 6 p.m. EDT",16124,16270,14832,-1292
ISNE,"6/28/2022 7 p.m. EDT",16747,16670,15034,-1713
ISNE,"6/28/2022 8 p.m. EDT",16658,16340,14458,-2200
ISNE,"6/28/2022 9 p.m. EDT",16090,15940,13987,-2103
ISNE,"6/28/2022 10 p.m. EDT",15382,15220,13462,-1920
ISNE,"6/28/2022 11 p.m. EDT",14079,13900,12263,-1816
ISNE,"6/29/2022 12 a.m. EDT",12915,12620,10962,-1953
ISNE,"6/29/2022 1 a.m. EDT",12310,11790,10020,-2290
ISNE,"6/29/2022 2 a.m. EDT",11672,11110,9652,-2020
ISNE,"6/29/2022 3 a.m. EDT",11497,10700,9780,-1717
ISNE,"6/29/2022 4 a.m. EDT",11303,10500,9583,-1720
ISNE,"6/29/2022 5 a.m. EDT",11380,10600,9642,-1738
ISNE,"6/29/2022 6 a.m. EDT",11409,11030,9850,-1559
ISNE,"6/29/2022 7 a.m. EDT",12020,11920,10051,-1969
ISNE,"6/29/2022 8 a.m. EDT",12834,12630,10959,-1875
ISNE,"6/29/2022 9 a.m. EDT",13098,12880,11488,-1610
ISNE,"6/29/2022 10 a.m. EDT",13200,13040,11949,-1251
ISNE,"6/29/2022 11 a.m. EDT",13499,13290,12362,-1137
ISNE,"6/29/2022 12 p.m. EDT",13944,13610,12814,-1130
ISNE,"6/29/2022 1 p.m. EDT",13995,14130,12937,-1058
ISNE,"6/29/2022 2 p.m. EDT",14463,14660,13596,-867
ISNE,"6/29/2022 3 p.m. EDT",14972,15340,14098,-874
ISNE,"6/29/2022 4 p.m. EDT",15608,15920,14562,-1046
ISNE,"6/29/2022 5 p.m. EDT",16469,16700,15082,-1387
ISNE,"6/29/2022 6 p.m. EDT",17342,17530,16046,-1296
ISNE,"6/29/2022 7 p.m. EDT",17595,17870,16057,-1538
ISNE,"6/29/2022 8 p.m. EDT",17232,17330,15849,-1383
ISNE,"6/29/2022 9 p.m. EDT",16776,16750,15285,-1491
ISNE,"6/29/2022 10 p.m. EDT",16071,16020,14661,-1410
ISNE,"6/29/2022 11 p.m. EDT",14715,14670,13326,-1389
ISNE,"6/30/2022 12 a.m. EDT",13644,13380,12095,-1549
ISNE,"6/30/2022 1 a.m. EDT",12942,12140,10815,-2127
ISNE,"6/30/2022 2 a.m. EDT",12528,11530,10349,-2179
ISNE,"6/30/2022 3 a.m. EDT",12291,11130,10215,-2076
ISNE,"6/30/2022 4 a.m. EDT",12008,10920,9927,-2081
ISNE,"6/30/2022 5 a.m. EDT",12037,10950,9922,-2115
ISNE,"6/30/2022 6 a.m. EDT",12310,11340,10287,-2023
ISNE,"6/30/2022 7 a.m. EDT",12778,12230,10453,-2325
ISNE,"6/30/2022 8 a.m. EDT",13386,12840,11280,-2106
ISNE,"6/30/2022 9 a.m. EDT",13080,13100,11195,-1885
ISNE,"6/30/2022 10 a.m. EDT",12911,12900,11060,-1851
ISNE,"6/30/2022 11 a.m. EDT",12982,13230,11500,-1482
ISNE,"6/30/2022 12 p.m. EDT",13262,13420,12068,-1194
ISNE,"6/30/2022 1 p.m. EDT",13667,13900,12616,-1051
ISNE,"6/30/2022 2 p.m. EDT",14207,14510,13236,-971
ISNE,"6/30/2022 3 p.m. EDT",14695,15330,13694,-1001
ISNE,"6/30/2022 4 p.m. EDT",15030,16010,14096,-934
ISNE,"6/30/2022 5 p.m. EDT",16019,16130,15292,-727
ISNE,"6/30/2022 6 p.m. EDT",17041,17110,16122,-919
ISNE,"6/30/2022 7 p.m. EDT",17552,17740,16434,-1118
ISNE,"6/30/2022 8 p.m. EDT",17263,17270,15954,-1309
ISNE,"6/30/2022 9 p.m. EDT",16752,16780,15387,-1365
ISNE,"6/30/2022 10 p.m. EDT",16122,16260,14499,-1623
ISNE,"6/30/2022 11 p.m. EDT",14808,14820,13290,-1518
ISNE,"7/1/2022 12 a.m. EDT",13761,13490,11620,-2141
