BA Code,Timestamp (Hour Ending),Demand (MWh),Demand Forecast (MWh),Net Generation (MWh),Total Interchange (MWh)
ISNE,2/1/2023 12 a.m. EST,13250,13220,10116,-3134
ISNE,2/1/2023 1 a.m. EST,13259,12700,9928,-3331
ISNE,2/1/2023 2 a.m. EST,13423,12300,9776,-3647
ISNE,2/1/2023 3 a.m. EST,13383,12220,9803,-3580
ISNE,2/1/2023 4 a.m. EST,13428,12340,9778,-3650
ISNE,2/1/2023 5 a.m. EST,13779,12720,10069,-3710
ISNE,2/1/2023 6 a.m. EST,13908,13650,10460,-3448
ISNE,2/1/2023 7 a.m. EST,15234,15260,11846,-3388
ISNE,2/1/2023 8 a.m. EST,16169,16240,12733,-3436
ISNE,2/1/2023 9 a.m. EST,15502,15530,12001,-3501
ISNE,2/1/2023 10 a.m. EST,14150,14140,10729,-3421
ISNE,2/1/2023 11 a.m. EST,13177,13270,10135,-3042
ISNE,2/1/2023 12 p.m. EST,13238,12840,10320,-2918
ISNE,2/1/2023 1 p.m. EST,13344,12650,10575,-2769
ISNE,2/1/2023 2 p.m. EST,13339,12870,10630,-2709
ISNE,2/1/2023 3 p.m. EST,13235,13520,10468,-2767
ISNE,2/1/2023 4 p.m. EST,14094,14490,10921,-3173
ISNE,2/1/2023 5 p.m. EST,15650,15750,12530,-3120
ISNE,2/1/2023 6 p.m. EST,16917,17030,13545,-3372
ISNE,2/1/2023 7 p.m. EST,17110,17190,13633,-3477
ISNE,2/1/2023 8 p.m. EST,16822,16820,13318,-3504
ISNE,2/1/2023 9 p.m. EST,16284,16170,12920,-3364
ISNE,2/1/2023 10 p.m. EST,15449,15410,11961,-3488
ISNE,2/1/2023 11 p.m. EST,14435,14430,10830,-3605
ISNE,2/2/2023 12 a.m. EST,13561,13610,9840,-3721
ISNE,2/2/2023 1 a.m. EST,13510,13020,9888,-3622
ISNE,2/2/2023 2 a.m. EST,13353,12720,9480,-3873
ISNE,2/2/2023 3 a.m. EST,13232,12610,9434,-3798
ISNE,2/2/2023 4 a.m. EST,13269,12660,9564,-3705
ISNE,2/2/2023 5 a.m. EST,13645,13050,9926,-3719
ISNE,2/2/2023 6 a.m. EST,14204,13960,10856,-3348
ISNE,2/2/2023 7 a.m. EST,15458,15520,12124,-3334
ISNE,2/2/2023 8 a.m. EST,16289,16300,12611,-3678
ISNE,2/2/2023 9 a.m. EST,15671,15650,11942,-3729
ISNE,2/2/2023 10 a.m. EST,14606,14580,10911,-3695
ISNE,2/2/2023 11 a.m. EST,13876,13720,10415,-3461
ISNE,2/2/2023 12 p.m. EST,13757,13170,10123,-3634
ISNE,2/2/2023 1 p.m. EST,13349,12680,9716,-3633
ISNE,2/2/2023 2 p.m. EST,13290,12480,9961,-3329
ISNE,2/2/2023 3 p.m. EST,13299,12900,10148,-3151
ISNE,2/2/2023 4 p.m. EST,14077,13920,10756,-3321
ISNE,2/2/2023 5 p.m. EST,15584,15660,12322,-3262
ISNE,2/2/2023 6 p.m. EST,16813,16820,13339,-3474
ISNE,2/2/2023 7 p.m. EST,16964,17010,13420,-3544
ISNE,2/2/2023 8 p.m. EST,16610,16540,13153,-3457
ISNE,2/2/2023 9 p.m. EST,16013,15840,12442,-3571
ISNE,2/2/2023 10 p.m. EST,15214,15020,11304,-3910
ISNE,2/2/2023 11 p.m. EST,14306,14000,10512,-3794
ISNE,2/3/2023 12 a.m. EST,13507,13120,9975,-3532
ISNE,2/3/2023 1 a.m. EST,13497,12680,9850,-3647
ISNE,2/3/2023 2 a.m. EST,13225,12330,9950,-3275
ISNE,2/3/2023 3 a.m. EST,13056,12170,10034,-3022
ISNE,2/3/2023 4 a.m. EST,13083,12210,10082,-3001
ISNE,2/3/2023 5 a.m. EST,12961,12550,9963,-2998
ISNE,2/3/2023 6 a.m. EST,13430,13490,10598,-2832
ISNE,2/3/2023 7 a.m. EST,15058,15130,11403,-3655
ISNE,2/3/2023 8 a.m. EST,16051,16090,12293,-3758
ISNE,2/3/2023 9 a.m. EST,15521,15530,11965,-3556
ISNE,2/3/2023 10 a.m. EST,14525,14530,11597,-2928
ISNE,2/3/2023 11 a.m. EST,13942,13950,11704,-2238
ISNE,2/3/2023 12 p.m. EST,13748,13760,11735,-2013
ISNE,2/3/2023 1 p.m. EST,13743,13760,11723,-2020
ISNE,2/3/2023 2 p.m. EST,14039,14060,11965,-2074
ISNE,2/3/2023 3 p.m. EST,14750,14800,12901,-1849
ISNE,2/3/2023 4 p.m. EST,16209,16270,14351,-1858
ISNE,2/3/2023 5 p.m. EST,17984,18040,16147,-1837
ISNE,2/3/2023 6 p.m. EST,19267,19320,17395,-1872
ISNE,2/3/2023 7 p.m. EST,19487,19500,18062,-1425
ISNE,2/3/2023 8 p.m. EST,19252,19270,18216,-1036
ISNE,2/3/2023 9 p.m. EST,18967,18980,17741,-1226
ISNE,2/3/2023 10 p.m. EST,18843,18540,17445,-1398
ISNE,2/3/2023 11 p.m. EST,18123,17750,16898,-1225
ISNE,2/4/2023 12 a.m. EST,17453,16890,16100,-1353
ISNE,2/4/2023 1 a.m. EST,16998,16680,15442,-1556
ISNE,2/4/2023 2 a.m. EST,16402,16410,15305,-1097
ISNE,2/4/2023 3 a.m. EST,16297,16290,15460,-837
ISNE,2/4/2023 4 a.m. EST,16273,16240,15659,-614
ISNE,2/4/2023 5 a.m. EST,16433,16440,15789,-644
ISNE,2/4/2023 6 a.m. EST,16783,16800,16382,-401
ISNE,2/4/2023 7 a.m. EST,17415,17450,17286,-129
ISNE,2/4/2023 8 a.m. EST,17976,18000,17744,-232
ISNE,2/4/2023 9 a.m. EST,17714,17700,16919,-795
ISNE,2/4/2023 10 a.m. EST,16987,16990,16167,-820
ISNE,2/4/2023 11 a.m. EST,16475,16460,15486,-989
ISNE,2/4/2023 12 p.m. EST,16079,16080,15302,-777
ISNE,2/4/2023 1 p.m. EST,16110,15800,15204,-906
ISNE,2/4/2023 2 p.m. EST,16177,15850,14935,-1242
ISNE,2/4/2023 3 p.m. EST,16898,16210,15382,-1516
ISNE,2/4/2023 4 p.m. EST,17978,17680,16063,-1915
ISNE,2/4/2023 5 p.m. EST,18639,18890,16760,-1879
ISNE,2/4/2023 6 p.m. EST,19287,19500,17348,-1939
ISNE,2/4/2023 7 p.m. EST,19092,19600,16913,-2179
ISNE,2/4/2023 8 p.m. EST,18593,18820,16375,-2218
ISNE,2/4/2023 9 p.m. EST,18037,18160,16004,-2033
ISNE,2/4/2023 10 p.m. EST,17283,17370,15306,-1977
ISNE,2/4/2023 11 p.m. EST,16390,16420,14002,-2388
ISNE,2/5/2023 12 a.m. EST,15533,15630,12705,-2828
ISNE,2/5/2023 1 a.m. EST,14846,14850,11800,-3046
ISNE,2/5/2023 2 a.m. EST,14358,14370,11556,-2802
ISNE,2/5/2023 3 a.m. EST,14054,14080,11476,-2578
ISNE,2/5/2023 4 a.m. EST,13871,13890,11484,-2387
ISNE,2/5/2023 5 a.m. EST,13795,13810,11240,-2555
ISNE,2/5/2023 6 a.m. EST,13917,13960,11121,-2796
ISNE,2/5/2023 7 a.m. EST,14299,14330,11174,-3125
ISNE,2/5/2023 8 a.m. EST,14548,14570,11401,-3147
ISNE,2/5/2023 9 a.m. EST,14404,14410,11270,-3134
ISNE,2/5/2023 10 a.m. EST,13949,13580,11277,-2672
ISNE,2/5/2023 11 a.m. EST,13605,13180,10740,-2865
ISNE,2/5/2023 12 p.m. EST,13128,13010,10037,-3091
ISNE,2/5/2023 1 p.m. EST,12997,12750,9802,-3195
ISNE,2/5/2023 2 p.m. EST,13134,12780,10279,-2855
ISNE,2/5/2023 3 p.m. EST,13613,13360,10654,-2959
ISNE,2/5/2023 4 p.m. EST,14247,14110,11216,-3031
ISNE,2/5/2023 5 p.m. EST,14813,15170,11905,-2908
ISNE,2/5/2023 6 p.m. EST,15996,16350,13103,-2893
ISNE,2/5/2023 7 p.m. EST,16061,16430,13028,-3033
ISNE,2/5/2023 8 p.m. EST,15621,15690,12544,-3077
ISNE,2/5/2023 9 p.m. EST,15021,15110,11971,-3050
ISNE,2/5/2023 10 p.m. EST,14630,14330,11656,-2974
ISNE,2/5/2023 11 p.m. EST,13956,13430,11120,-2836
ISNE,2/6/2023 12 a.m. EST,13135,12690,10101,-3034
ISNE,2/6/2023 1 a.m. EST,12426,11850,9412,-3014
ISNE,2/6/2023 2 a.m. EST,12347,11530,9192,-3155
ISNE,2/6/2023 3 a.m. EST,12240,11410,9051,-3189
ISNE,2/6/2023 4 a.m. EST,12540,11470,9237,-3303
ISNE,2/6/2023 5 a.m. EST,12659,11850,9675,-2984
ISNE,2/6/2023 6 a.m. EST,12782,12800,9993,-2789
ISNE,2/6/2023 7 a.m. EST,14271,14330,10966,-3305
ISNE,2/6/2023 8 a.m. EST,15169,15210,11657,-3512
ISNE,2/6/2023 9 a.m. EST,15037,15060,11584,-3453
ISNE,2/6/2023 10 a.m. EST,14315,14200,11136,-3179
ISNE,2/6/2023 11 a.m. EST,14091,13290,11017,-3074
ISNE,2/6/2023 12 p.m. EST,13786,12910,11150,-2636
ISNE,2/6/2023 1 p.m. EST,13687,12860,11283,-2404
ISNE,2/6/2023 2 p.m. EST,13656,13030,11254,-2402
ISNE,2/6/2023 3 p.m. EST,14032,13400,11526,-2506
ISNE,2/6/2023 4 p.m. EST,14542,14060,11866,-2676
ISNE,2/6/2023 5 p.m. EST,15046,15030,12597,-2449
ISNE,2/6/2023 6 p.m. EST,16199,16190,13964,-2235
ISNE,2/6/2023 7 p.m. EST,16350,16440,13949,-2401
ISNE,2/6/2023 8 p.m. EST,15935,16020,13453,-2482
ISNE,2/6/2023 9 p.m. EST,15369,15390,13151,-2218
ISNE,2/6/2023 10 p.m. EST,14535,14540,12246,-2289
ISNE,2/6/2023 11 p.m. EST,13518,13560,11094,-2424
ISNE,2/7/2023 12 a.m. EST,13053,12720,10336,-2717
ISNE,2/7/2023 1 a.m. EST,12818,12220,10365,-2453
ISNE,2/7/2023 2 a.m. EST,12798,12010,10395,-2403
ISNE,2/7/2023 3 a.m. EST,12763,11950,10427,-2336
ISNE,2/7/2023 4 a.m. EST,12876,12060,10505,-2371
ISNE,2/7/2023 5 a.m. EST,13287,12500,10878,-2409
ISNE,2/7/2023 6 a.m. EST,13572,13490,11309,-2263
ISNE,2/7/2023 7 a.m. EST,15034,15100,12545,-2489
ISNE,2/7/2023 8 a.m. EST,15741,15750,13699,-2042
ISNE,2/7/2023 9 a.m. EST,14726,14730,12507,-2219
ISNE,2/7/2023 10 a.m. EST,13619,13370,11309,-2310
ISNE,2/7/2023 11 a.m. EST,13376,12830,11091,-2285
ISNE,2/7/2023 12 p.m. EST,13061,12650,11276,-1785
ISNE,2/7/2023 1 p.m. EST,12695,12630,10578,-2117
ISNE,2/7/2023 2 p.m. EST,13061,13100,,
ISNE,2/7/2023 3 p.m. EST,13426,13570,11265,-2161
ISNE,2/7/2023 4 p.m. EST,14446,14330,12361,-2085
ISNE,2/7/2023 5 p.m. EST,15594,15550,13506,-2088
ISNE,2/7/2023 6 p.m. EST,16710,16690,14567,-2143
ISNE,2/7/2023 7 p.m. EST,16736,16750,14529,-2207
ISNE,2/7/2023 8 p.m. EST,16274,16240,13899,-2375
ISNE,2/7/2023 9 p.m. EST,15610,15500,13213,-2397
ISNE,2/7/2023 10 p.m. EST,14716,14610,12392,-2324
ISNE,2/7/2023 11 p.m. EST,13875,13540,11524,-2351
ISNE,2/8/2023 12 a.m. EST,13180,12620,10530,-2650
ISNE,2/8/2023 1 a.m. EST,12420,12030,10431,-1989
ISNE,2/8/2023 2 a.m. EST,12476,11650,10186,-2290
ISNE,2/8/2023 3 a.m. EST,12358,11470,10091,-2267
ISNE,2/8/2023 4 a.m. EST,12124,11470,10019,-2105
ISNE,2/8/2023 5 a.m. EST,12054,11780,10039,-2015
ISNE,2/8/2023 6 a.m. EST,12638,12710,10460,-2178
ISNE,2/8/2023 7 a.m. EST,14115,14180,11822,-2293
ISNE,2/8/2023 8 a.m. EST,14834,14860,12384,-2450
ISNE,2/8/2023 9 a.m. EST,14556,14570,12191,-2365
ISNE,2/8/2023 10 a.m. EST,14012,13930,11528,-2484
ISNE,2/8/2023 11 a.m. EST,13330,12850,10866,-2464
ISNE,2/8/2023 12 p.m. EST,13275,12280,10741,-2534
ISNE,2/8/2023 1 p.m. EST,12838,12070,10330,-2508
ISNE,2/8/2023 2 p.m. EST,12278,12040,10204,-2074
ISNE,2/8/2023 3 p.m. EST,12307,12380,10481,-1826
ISNE,2/8/2023 4 p.m. EST,12697,13350,10714,-1983
ISNE,2/8/2023 5 p.m. EST,14197,14520,11805,-2392
ISNE,2/8/2023 6 p.m. EST,15537,15710,13165,-2372
ISNE,2/8/2023 7 p.m. EST,15830,16100,13275,-2555
ISNE,2/8/2023 8 p.m. EST,15495,15580,13021,-2474
ISNE,2/8/2023 9 p.m. EST,14955,14960,12451,-2504
ISNE,2/8/2023 10 p.m. EST,14152,14190,11511,-2641
ISNE,2/8/2023 11 p.m. EST,13130,13240,10847,-2283
ISNE,2/9/2023 12 a.m. EST,12518,12380,10370,-2148
ISNE,2/9/2023 1 a.m. EST,11786,11740,9929,-1857
ISNE,2/9/2023 2 a.m. EST,12061,11470,9838,-2223
ISNE,2/9/2023 3 a.m. EST,12016,11380,9767,-2249
ISNE,2/9/2023 4 a.m. EST,12088,11460,9870,-2218
ISNE,2/9/2023 5 a.m. EST,12307,11830,10095,-2212
ISNE,2/9/2023 6 a.m. EST,12945,12820,10680,-2265
ISNE,2/9/2023 7 a.m. EST,14284,14340,11859,-2425
ISNE,2/9/2023 8 a.m. EST,14920,14990,12324,-2596
ISNE,2/9/2023 9 a.m. EST,14328,14290,12120,-2208
ISNE,2/9/2023 10 a.m. EST,13828,13950,11992,-1836
ISNE,2/9/2023 11 a.m. EST,13912,14000,12150,-1762
ISNE,2/9/2023 12 p.m. EST,14131,14100,12261,-1870
ISNE,2/9/2023 1 p.m. EST,14305,14120,12316,-1989
ISNE,2/9/2023 2 p.m. EST,14457,14300,12290,-2167
ISNE,2/9/2023 3 p.m. EST,14567,14390,12193,-2374
ISNE,2/9/2023 4 p.m. EST,14806,14650,12398,-2408
ISNE,2/9/2023 5 p.m. EST,15297,15280,13186,-2111
ISNE,2/9/2023 6 p.m. EST,15929,15930,13810,-2119
ISNE,2/9/2023 7 p.m. EST,15836,15980,13862,-1974
ISNE,2/9/2023 8 p.m. EST,15343,15370,13451,-1892
ISNE,2/9/2023 9 p.m. EST,14679,14600,12637,-2042
ISNE,2/9/2023 10 p.m. EST,13760,13710,11697,-2063
ISNE,2/9/2023 11 p.m. EST,12663,12620,10903,-1760
ISNE,2/10/2023 12 a.m. EST,11862,11690,10173,-1689
ISNE,2/10/2023 1 a.m. EST,11657,11080,10095,-1562
ISNE,2/10/2023 2 a.m. EST,11546,10710,9711,-1835
ISNE,2/10/2023 3 a.m. EST,11408,10520,9402,-2006
ISNE,2/10/2023 4 a.m. EST,11621,10510,9552,-2069
ISNE,2/10/2023 5 a.m. EST,11710,10810,9671,-2039
ISNE,2/10/2023 6 a.m. EST,11987,11660,9702,-2285
ISNE,2/10/2023 7 a.m. EST,13199,13050,10822,-2377
ISNE,2/10/2023 8 a.m. EST,13612,13600,11381,-2231
ISNE,2/10/2023 9 a.m. EST,13096,13020,11029,-2067
ISNE,2/10/2023 10 a.m. EST,12323,12380,10290,-2033
ISNE,2/10/2023 11 a.m. EST,11506,11580,9752,-1754
ISNE,2/10/2023 12 p.m. EST,11143,11210,9741,-1402
ISNE,2/10/2023 1 p.m. EST,10916,10980,9233,-1683
ISNE,2/10/2023 2 p.m. EST,10858,10970,9158,-1700
ISNE,2/10/2023 3 p.m. EST,11010,11530,9093,-1917
ISNE,2/10/2023 4 p.m. EST,11962,12350,9857,-2105
ISNE,2/10/2023 5 p.m. EST,13259,13450,11053,-2206
ISNE,2/10/2023 6 p.m. EST,14296,14550,12106,-2190
ISNE,2/10/2023 7 p.m. EST,14469,14840,12166,-2303
ISNE,2/10/2023 8 p.m. EST,14105,14390,11881,-2224
ISNE,2/10/2023 9 p.m. EST,13638,13830,11013,-2625
ISNE,2/10/2023 10 p.m. EST,13040,13290,10615,-2425
ISNE,2/10/2023 11 p.m. EST,12258,12510,10197,-2061
ISNE,2/11/2023 12 a.m. EST,11577,11720,9815,-1762
ISNE,2/11/2023 1 a.m. EST,11269,11040,9373,-1896
ISNE,2/11/2023 2 a.m. EST,10959,10790,9117,-1842
ISNE,2/11/2023 3 a.m. EST,10840,10650,8930,-1910
ISNE,2/11/2023 4 a.m. EST,10859,10670,8899,-1960
ISNE,2/11/2023 5 a.m. EST,11042,10880,9047,-1995
ISNE,2/11/2023 6 a.m. EST,11509,11270,9275,-2234
ISNE,2/11/2023 7 a.m. EST,11888,11980,9780,-2108
ISNE,2/11/2023 8 a.m. EST,12335,12330,10169,-2166
ISNE,2/11/2023 9 a.m. EST,11889,11920,9971,-1918
ISNE,2/11/2023 10 a.m. EST,11140,11230,9653,-1487
ISNE,2/11/2023 11 a.m. EST,10666,10430,9217,-1449
ISNE,2/11/2023 12 p.m. EST,10236,10140,9011,-1225
ISNE,2/11/2023 1 p.m. EST,10048,10050,8898,-1150
ISNE,2/11/2023 2 p.m. EST,10124,9940,8960,-1164
ISNE,2/11/2023 3 p.m. EST,10355,10580,8947,-1408
ISNE,2/11/2023 4 p.m. EST,11483,11810,9526,-1957
ISNE,2/11/2023 5 p.m. EST,12977,13280,10690,-2287
ISNE,2/11/2023 6 p.m. EST,14322,14530,11826,-2496
ISNE,2/11/2023 7 p.m. EST,14621,14820,12184,-2437
ISNE,2/11/2023 8 p.m. EST,14371,14470,11903,-2468
ISNE,2/11/2023 9 p.m. EST,13997,13970,11632,-2365
ISNE,2/11/2023 10 p.m. EST,13475,13430,11067,-2408
ISNE,2/11/2023 11 p.m. EST,12800,12780,10573,-2227
ISNE,2/12/2023 12 a.m. EST,12350,12090,10298,-2052
ISNE,2/12/2023 1 a.m. EST,11981,11660,9876,-2105
ISNE,2/12/2023 2 a.m. EST,12039,11340,9815,-2224
ISNE,2/12/2023 3 a.m. EST,12005,11190,9981,-2024
ISNE,2/12/2023 4 a.m. EST,11801,11150,9688,-2113
ISNE,2/12/2023 5 a.m. EST,11790,11250,9548,-2242
ISNE,2/12/2023 6 a.m. EST,11869,11580,9334,-2535
ISNE,2/12/2023 7 a.m. EST,12077,12100,9455,-2622
ISNE,2/12/2023 8 a.m. EST,12350,12370,9720,-2630
ISNE,2/12/2023 9 a.m. EST,12058,12010,9678,-2380
ISNE,2/12/2023 10 a.m. EST,11745,11310,9451,-2294
ISNE,2/12/2023 11 a.m. EST,11301,10870,9272,-2029
ISNE,2/12/2023 12 p.m. EST,11138,10750,9114,-2024
ISNE,2/12/2023 1 p.m. EST,11166,10810,9089,-2077
ISNE,2/12/2023 2 p.m. EST,11419,11350,9134,-2285
ISNE,2/12/2023 3 p.m. EST,11968,11940,9597,-2371
ISNE,2/12/2023 4 p.m. EST,12811,12870,10376,-2435
ISNE,2/12/2023 5 p.m. EST,13860,14130,11200,-2660
ISNE,2/12/2023 6 p.m. EST,14988,15160,12413,-2575
ISNE,2/12/2023 7 p.m. EST,14920,14980,12260,-2660
ISNE,2/12/2023 8 p.m. EST,14168,14680,11425,-2743
ISNE,2/12/2023 9 p.m. EST,13612,14170,10964,-2648
ISNE,2/12/2023 10 p.m. EST,13113,13400,10709,-2404
ISNE,2/12/2023 11 p.m. EST,12555,12520,10177,-2378
ISNE,2/13/2023 12 a.m. EST,12012,11740,9485,-2527
ISNE,2/13/2023 1 a.m. EST,11661,11100,9068,-2593
ISNE,2/13/2023 2 a.m. EST,11878,10790,9145,-2733
ISNE,2/13/2023 3 a.m. EST,11774,10660,9025,-2749
ISNE,2/13/2023 4 a.m. EST,11787,10710,9088,-2699
ISNE,2/13/2023 5 a.m. EST,11822,11080,9197,-2625
ISNE,2/13/2023 6 a.m. EST,12218,12130,9634,-2584
ISNE,2/13/2023 7 a.m. EST,13412,13720,11303,-2109
ISNE,2/13/2023 8 a.m. EST,14259,14620,12372,-1887
ISNE,2/13/2023 9 a.m. EST,14061,14280,11718,-2343
ISNE,2/13/2023 10 a.m. EST,13487,13490,11097,-2390
ISNE,2/13/2023 11 a.m. EST,13015,13070,10703,-2312
ISNE,2/13/2023 12 p.m. EST,12544,12740,10155,-2389
ISNE,2/13/2023 1 p.m. EST,12008,12480,9729,-2279
ISNE,2/13/2023 2 p.m. EST,11803,12500,9429,-2374
ISNE,2/13/2023 3 p.m. EST,11973,12730,9441,-2532
ISNE,2/13/2023 4 p.m. EST,12676,13390,10071,-2605
ISNE,2/13/2023 5 p.m. EST,13997,14540,11728,-2269
ISNE,2/13/2023 6 p.m. EST,15309,15720,12958,-2351
ISNE,2/13/2023 7 p.m. EST,15599,15890,13394,-2205
ISNE,2/13/2023 8 p.m. EST,15204,15460,12797,-2407
ISNE,2/13/2023 9 p.m. EST,14601,14780,12220,-2381
ISNE,2/13/2023 10 p.m. EST,13704,13910,11387,-2317
ISNE,2/13/2023 11 p.m. EST,12668,12890,10340,-2328
ISNE,2/14/2023 12 a.m. EST,12026,12020,9666,-2360
ISNE,2/14/2023 1 a.m. EST,11989,11410,9387,-2602
ISNE,2/14/2023 2 a.m. EST,11746,11060,9081,-2665
ISNE,2/14/2023 3 a.m. EST,11621,10940,8893,-2728
ISNE,2/14/2023 4 a.m. EST,11378,10710,8594,-2784
ISNE,2/14/2023 5 a.m. EST,11723,11050,8963,-2760
ISNE,2/14/2023 6 a.m. EST,12434,11990,9605,-2829
ISNE,2/14/2023 7 a.m. EST,13495,13470,10583,-2912
ISNE,2/14/2023 8 a.m. EST,14153,14220,11254,-2899
ISNE,2/14/2023 9 a.m. EST,13452,13450,10556,-2896
ISNE,2/14/2023 10 a.m. EST,12360,12490,9711,-2649
ISNE,2/14/2023 11 a.m. EST,11483,11800,9396,-2087
ISNE,2/14/2023 12 p.m. EST,10952,11350,8675,-2277
ISNE,2/14/2023 1 p.m. EST,10653,11140,8821,-1832
ISNE,2/14/2023 2 p.m. EST,10628,11160,9106,-1522
ISNE,2/14/2023 3 p.m. EST,10852,11530,9260,-1592
ISNE,2/14/2023 4 p.m. EST,11796,12480,9458,-2338
ISNE,2/14/2023 5 p.m. EST,13340,13830,10665,-2675
ISNE,2/14/2023 6 p.m. EST,14740,15340,11591,-3149
ISNE,2/14/2023 7 p.m. EST,15113,15650,12093,-3020
ISNE,2/14/2023 8 p.m. EST,14807,15280,11698,-3109
ISNE,2/14/2023 9 p.m. EST,14290,14680,11126,-3164
ISNE,2/14/2023 10 p.m. EST,13579,13880,10650,-2929
ISNE,2/14/2023 11 p.m. EST,12661,12890,9766,-2895
ISNE,2/15/2023 12 a.m. EST,12141,12030,9511,-2630
ISNE,2/15/2023 1 a.m. EST,11663,11380,9227,-2436
ISNE,2/15/2023 2 a.m. EST,11610,11090,8998,-2612
ISNE,2/15/2023 3 a.m. EST,11513,10920,8957,-2556
ISNE,2/15/2023 4 a.m. EST,11550,10950,9027,-2523
ISNE,2/15/2023 5 a.m. EST,11881,11240,9385,-2496
ISNE,2/15/2023 6 a.m. EST,12547,12110,9801,-2746
ISNE,2/15/2023 7 a.m. EST,13652,13420,10993,-2659
ISNE,2/15/2023 8 a.m. EST,14496,14130,12146,-2350
ISNE,2/15/2023 9 a.m. EST,14573,13940,12153,-2420
ISNE,2/15/2023 10 a.m. EST,13909,13360,11453,-2456
ISNE,2/15/2023 11 a.m. EST,13114,12730,10554,-2560
ISNE,2/15/2023 12 p.m. EST,12352,12220,10107,-2245
ISNE,2/15/2023 1 p.m. EST,11659,11830,9473,-2186
ISNE,2/15/2023 2 p.m. EST,11429,11710,9605,-1824
ISNE,2/15/2023 3 p.m. EST,11714,11890,9837,-1877
ISNE,2/15/2023 4 p.m. EST,12307,12580,10169,-2138
ISNE,2/15/2023 5 p.m. EST,13388,13690,11353,-2035
ISNE,2/15/2023 6 p.m. EST,14588,14920,12082,-2506
ISNE,2/15/2023 7 p.m. EST,14870,15030,12418,-2452
ISNE,2/15/2023 8 p.m. EST,14486,14590,12028,-2458
ISNE,2/15/2023 9 p.m. EST,13849,13940,11199,-2650
ISNE,2/15/2023 10 p.m. EST,12991,13080,10688,-2303
ISNE,2/15/2023 11 p.m. EST,12002,12090,10214,-1788
ISNE,2/16/2023 12 a.m. EST,11305,11230,9321,-1984