"BA Code","Timestamp (Hour Ending)","Demand (MWh)","Demand Forecast (MWh)","Net Generation (MWh)","Total Interchange (MWh)"
ISNE,"2/1/2022 12 a.m. EST",14659,14390,11651,-3008
ISNE,"2/1/2022 1 a.m. EST",14152,14000,11275,-2877
ISNE,"2/1/2022 2 a.m. EST",14449,13730,11669,-2780
ISNE,"2/1/2022 3 a.m. EST",14411,13710,11809,-2602
ISNE,"2/1/2022 4 a.m. EST",14497,13640,11876,-2621
ISNE,"2/1/2022 5 a.m. EST",14534,14050,11783,-2751
ISNE,"2/1/2022 6 a.m. EST",15225,15020,12544,-2681
ISNE,"2/1/2022 7 a.m. EST",16779,16470,14124,-2655
ISNE,"2/1/2022 8 a.m. EST",17680,17340,15154,-2526
ISNE,"2/1/2022 9 a.m. EST",17434,17370,14400,-3034
ISNE,"2/1/2022 10 a.m. EST",16801,17020,13866,-2935
ISNE,"2/1/2022 11 a.m. EST",16672,16760,13468,-3204
ISNE,"2/1/2022 12 p.m. EST",16544,16500,13581,-2963
ISNE,"2/1/2022 1 p.m. EST",16375,16390,13472,-2903
ISNE,"2/1/2022 2 p.m. EST",16229,16240,12921,-3308
ISNE,"2/1/2022 3 p.m. EST",16263,16040,12994,-3269
ISNE,"2/1/2022 4 p.m. EST",16362,16150,13183,-3179
ISNE,"2/1/2022 5 p.m. EST",16986,16630,13838,-3148
ISNE,"2/1/2022 6 p.m. EST",17855,17840,14571,-3284
ISNE,"2/1/2022 7 p.m. EST",17815,17860,14625,-3190
ISNE,"2/1/2022 8 p.m. EST",17376,17120,14219,-3157
ISNE,"2/1/2022 9 p.m. EST",16629,16310,13420,-3209
ISNE,"2/1/2022 10 p.m. EST",15670,15290,12442,-3228
ISNE,"2/1/2022 11 p.m. EST",14491,14210,11331,-3160
ISNE,"2/2/2022 12 a.m. EST",13805,13240,10411,-3394
ISNE,"2/2/2022 1 a.m. EST",13233,12890,10030,-3203
ISNE,"2/2/2022 2 a.m. EST",13158,12540,9956,-3202
ISNE,"2/2/2022 3 a.m. EST",13221,12370,9823,-3398
ISNE,"2/2/2022 4 a.m. EST",13209,12360,9839,-3370
ISNE,"2/2/2022 5 a.m. EST",13351,12650,10031,-3320
ISNE,"2/2/2022 6 a.m. EST",13871,13530,10605,-3266
ISNE,"2/2/2022 7 a.m. EST",14954,14980,11607,-3347
ISNE,"2/2/2022 8 a.m. EST",15867,15890,12706,-3161
ISNE,"2/2/2022 9 a.m. EST",15992,16060,12744,-3248
ISNE,"2/2/2022 10 a.m. EST",15738,15710,12453,-3285
ISNE,"2/2/2022 11 a.m. EST",15409,15500,12010,-3399
ISNE,"2/2/2022 12 p.m. EST",15001,15140,11553,-3448
ISNE,"2/2/2022 1 p.m. EST",14908,14870,11432,-3476
ISNE,"2/2/2022 2 p.m. EST",14753,14810,11329,-3424
ISNE,"2/2/2022 3 p.m. EST",14446,14890,11077,-3369
ISNE,"2/2/2022 4 p.m. EST",15110,15250,11693,-3417
ISNE,"2/2/2022 5 p.m. EST",15637,15930,12207,-3430
ISNE,"2/2/2022 6 p.m. EST",16651,17000,13118,-3533
ISNE,"2/2/2022 7 p.m. EST",16672,16760,13021,-3651
ISNE,"2/2/2022 8 p.m. EST",16185,16190,12481,-3704
ISNE,"2/2/2022 9 p.m. EST",15509,15330,11744,-3765
ISNE,"2/2/2022 10 p.m. EST",14631,14430,10756,-3875
ISNE,"2/2/2022 11 p.m. EST",13743,13390,9810,-3933
ISNE,"2/3/2022 12 a.m. EST",13117,12480,9124,-3993
ISNE,"2/3/2022 1 a.m. EST",13034,11960,9199,-3835
ISNE,"2/3/2022 2 a.m. EST",12690,11580,8827,-3863
ISNE,"2/3/2022 3 a.m. EST",12497,11390,8351,-4146
ISNE,"2/3/2022 4 a.m. EST",12487,11390,8281,-4206
ISNE,"2/3/2022 5 a.m. EST",12780,11630,8636,-4144
ISNE,"2/3/2022 6 a.m. EST",13623,12500,9590,-4033
ISNE,"2/3/2022 7 a.m. EST",14380,14120,10633,-3747
ISNE,"2/3/2022 8 a.m. EST",14999,15040,11478,-3521
ISNE,"2/3/2022 9 a.m. EST",15224,15250,11567,-3657
ISNE,"2/3/2022 10 a.m. EST",15216,15280,11463,-3753
ISNE,"2/3/2022 11 a.m. EST",15016,15340,11568,-3448
ISNE,"2/3/2022 12 p.m. EST",14896,15330,11281,-3615
ISNE,"2/3/2022 1 p.m. EST",14909,15300,11151,-3758
ISNE,"2/3/2022 2 p.m. EST",14984,15300,11411,-3573
ISNE,"2/3/2022 3 p.m. EST",14977,15280,11364,-3613
ISNE,"2/3/2022 4 p.m. EST",15112,15370,11540,-3572
ISNE,"2/3/2022 5 p.m. EST",15607,15830,11832,-3775
ISNE,"2/3/2022 6 p.m. EST",16352,16550,12552,-3800
ISNE,"2/3/2022 7 p.m. EST",16275,16470,12434,-3841
ISNE,"2/3/2022 8 p.m. EST",15730,15850,11909,-3821
ISNE,"2/3/2022 9 p.m. EST",15058,15160,11215,-3843
ISNE,"2/3/2022 10 p.m. EST",14389,14220,10518,-3871
ISNE,"2/3/2022 11 p.m. EST",13892,13100,9943,-3949
ISNE,"2/4/2022 12 a.m. EST",13383,12120,9618,-3765
ISNE,"2/4/2022 1 a.m. EST",12795,11680,8857,-3938
ISNE,"2/4/2022 2 a.m. EST",12408,11310,8490,-3918
ISNE,"2/4/2022 3 a.m. EST",12239,11150,8329,-3910
ISNE,"2/4/2022 4 a.m. EST",12236,11150,8413,-3823
ISNE,"2/4/2022 5 a.m. EST",12515,11420,8794,-3721
ISNE,"2/4/2022 6 a.m. EST",12864,12260,9265,-3599
ISNE,"2/4/2022 7 a.m. EST",13714,13640,10152,-3562
ISNE,"2/4/2022 8 a.m. EST",14507,14810,11023,-3484
ISNE,"2/4/2022 9 a.m. EST",15368,15460,11765,-3603
ISNE,"2/4/2022 10 a.m. EST",15901,15830,12515,-3386
ISNE,"2/4/2022 11 a.m. EST",16253,16130,12983,-3270
ISNE,"2/4/2022 12 p.m. EST",16525,16230,13448,-3077
ISNE,"2/4/2022 1 p.m. EST",16673,16660,13689,-2984
ISNE,"2/4/2022 2 p.m. EST",16702,16670,13302,-3400
ISNE,"2/4/2022 3 p.m. EST",16591,16660,13154,-3437
ISNE,"2/4/2022 4 p.m. EST",16580,16660,13109,-3471
ISNE,"2/4/2022 5 p.m. EST",16908,16720,13729,-3179
ISNE,"2/4/2022 6 p.m. EST",17546,17300,14188,-3358
ISNE,"2/4/2022 7 p.m. EST",17335,17150,13975,-3360
ISNE,"2/4/2022 8 p.m. EST",16738,16560,13450,-3288
ISNE,"2/4/2022 9 p.m. EST",16056,15930,12616,-3440
ISNE,"2/4/2022 10 p.m. EST",15312,15130,11839,-3473
ISNE,"2/4/2022 11 p.m. EST",14437,14200,10976,-3461
ISNE,"2/5/2022 12 a.m. EST",13619,13280,10109,-3510
ISNE,"2/5/2022 1 a.m. EST",13159,12850,9759,-3400
ISNE,"2/5/2022 2 a.m. EST",13142,12500,9738,-3404
ISNE,"2/5/2022 3 a.m. EST",13103,12350,9630,-3473
ISNE,"2/5/2022 4 a.m. EST",13057,12330,9412,-3645
ISNE,"2/5/2022 5 a.m. EST",13217,12500,9590,-3627
ISNE,"2/5/2022 6 a.m. EST",13392,12900,9873,-3519
ISNE,"2/5/2022 7 a.m. EST",14122,13810,10561,-3561
ISNE,"2/5/2022 8 a.m. EST",14584,14550,11284,-3300
ISNE,"2/5/2022 9 a.m. EST",15276,15210,12001,-3275
ISNE,"2/5/2022 10 a.m. EST",15550,15290,12399,-3151
ISNE,"2/5/2022 11 a.m. EST",15428,15000,12222,-3206
ISNE,"2/5/2022 12 p.m. EST",15085,14590,12042,-3043
ISNE,"2/5/2022 1 p.m. EST",14758,14870,11694,-3064
ISNE,"2/5/2022 2 p.m. EST",14534,14800,11594,-2940
ISNE,"2/5/2022 3 p.m. EST",14584,15030,11819,-2765
ISNE,"2/5/2022 4 p.m. EST",15060,15680,12441,-2619
ISNE,"2/5/2022 5 p.m. EST",15987,16670,13492,-2495
ISNE,"2/5/2022 6 p.m. EST",17164,17370,14533,-2631
ISNE,"2/5/2022 7 p.m. EST",17365,17400,14893,-2472
ISNE,"2/5/2022 8 p.m. EST",16997,17020,14505,-2492
ISNE,"2/5/2022 9 p.m. EST",16556,16540,13897,-2659
ISNE,"2/5/2022 10 p.m. EST",15995,16020,13234,-2761
ISNE,"2/5/2022 11 p.m. EST",15266,15380,12428,-2838
ISNE,"2/6/2022 12 a.m. EST",14569,14720,11923,-2646
ISNE,"2/6/2022 1 a.m. EST",14050,14110,11921,-2129
ISNE,"2/6/2022 2 a.m. EST",13962,13790,11370,-2592
ISNE,"2/6/2022 3 a.m. EST",13854,13660,11240,-2614
ISNE,"2/6/2022 4 a.m. EST",13835,13590,11389,-2446
ISNE,"2/6/2022 5 a.m. EST",13956,13750,11515,-2441
ISNE,"2/6/2022 6 a.m. EST",14274,14050,11546,-2728
ISNE,"2/6/2022 7 a.m. EST",14561,14560,11921,-2640
ISNE,"2/6/2022 8 a.m. EST",15149,14980,12408,-2741
ISNE,"2/6/2022 9 a.m. EST",15337,15260,12645,-2692
ISNE,"2/6/2022 10 a.m. EST",15203,15210,12740,-2463
ISNE,"2/6/2022 11 a.m. EST",14867,14930,12287,-2580
ISNE,"2/6/2022 12 p.m. EST",14439,14660,11793,-2646
ISNE,"2/6/2022 1 p.m. EST",14331,14320,11788,-2543
ISNE,"2/6/2022 2 p.m. EST",14202,14260,11754,-2448
ISNE,"2/6/2022 3 p.m. EST",14329,14490,12025,-2304
ISNE,"2/6/2022 4 p.m. EST",14865,15240,12506,-2359
ISNE,"2/6/2022 5 p.m. EST",15901,16350,13557,-2344
ISNE,"2/6/2022 6 p.m. EST",17165,17350,14843,-2322
ISNE,"2/6/2022 7 p.m. EST",17398,17490,15001,-2397
ISNE,"2/6/2022 8 p.m. EST",16988,17000,14494,-2494
ISNE,"2/6/2022 9 p.m. EST",16413,16380,14011,-2402
ISNE,"2/6/2022 10 p.m. EST",15582,15580,13362,-2220
ISNE,"2/6/2022 11 p.m. EST",14812,14640,12304,-2508
ISNE,"2/7/2022 12 a.m. EST",13948,13800,11638,-2310
ISNE,"2/7/2022 1 a.m. EST",13472,13170,11143,-2329
ISNE,"2/7/2022 2 a.m. EST",13199,12870,10931,-2268
ISNE,"2/7/2022 3 a.m. EST",13069,12750,10649,-2420
ISNE,"2/7/2022 4 a.m. EST",13135,12820,11061,-2074
ISNE,"2/7/2022 5 a.m. EST",13445,13170,11252,-2193
ISNE,"2/7/2022 6 a.m. EST",14063,14110,11750,-2313
ISNE,"2/7/2022 7 a.m. EST",15547,15590,12911,-2636
ISNE,"2/7/2022 8 a.m. EST",16541,16560,13725,-2816
ISNE,"2/7/2022 9 a.m. EST",16897,16900,14085,-2812
ISNE,"2/7/2022 10 a.m. EST",16884,16900,14137,-2747
ISNE,"2/7/2022 11 a.m. EST",16607,16890,13751,-2856
ISNE,"2/7/2022 12 p.m. EST",16196,16860,13079,-3117
ISNE,"2/7/2022 1 p.m. EST",15983,16840,13045,-2938
ISNE,"2/7/2022 2 p.m. EST",15973,16830,13011,-2962
ISNE,"2/7/2022 3 p.m. EST",15903,16680,12809,-3094
ISNE,"2/7/2022 4 p.m. EST",16058,16580,12954,-3104
ISNE,"2/7/2022 5 p.m. EST",16567,16720,13547,-3020
ISNE,"2/7/2022 6 p.m. EST",17365,17500,14392,-2973
ISNE,"2/7/2022 7 p.m. EST",17212,17270,14248,-2964
ISNE,"2/7/2022 8 p.m. EST",16611,16600,13526,-3085
ISNE,"2/7/2022 9 p.m. EST",15848,15850,12742,-3106
ISNE,"2/7/2022 10 p.m. EST",14894,14840,11654,-3240
ISNE,"2/7/2022 11 p.m. EST",13740,13760,10688,-3052
ISNE,"2/8/2022 12 a.m. EST",12819,12800,9655,-3164
ISNE,"2/8/2022 1 a.m. EST",12949,12170,9621,-3328
ISNE,"2/8/2022 2 a.m. EST",12700,11830,9380,-3320
ISNE,"2/8/2022 3 a.m. EST",12517,11650,9185,-3332
ISNE,"2/8/2022 4 a.m. EST",12502,11650,9273,-3229
ISNE,"2/8/2022 5 a.m. EST",12806,11970,10011,-2795
ISNE,"2/8/2022 6 a.m. EST",13444,12850,11085,-2359
ISNE,"2/8/2022 7 a.m. EST",14399,14320,12394,-2005
ISNE,"2/8/2022 8 a.m. EST",15197,15210,13194,-2003
ISNE,"2/8/2022 9 a.m. EST",15344,15350,13375,-1969
ISNE,"2/8/2022 10 a.m. EST",14965,14940,12957,-2008
ISNE,"2/8/2022 11 a.m. EST",14912,14520,12792,-2120
ISNE,"2/8/2022 12 p.m. EST",14785,14220,12774,-2011
ISNE,"2/8/2022 1 p.m. EST",14715,13970,12926,-1789
ISNE,"2/8/2022 2 p.m. EST",14923,13900,13034,-1889
ISNE,"2/8/2022 3 p.m. EST",15103,14030,13154,-1949
ISNE,"2/8/2022 4 p.m. EST",15283,14530,13349,-1934
ISNE,"2/8/2022 5 p.m. EST",15637,15280,13915,-1722
ISNE,"2/8/2022 6 p.m. EST",16624,16430,14588,-2036
ISNE,"2/8/2022 7 p.m. EST",16735,16900,14638,-2097
ISNE,"2/8/2022 8 p.m. EST",16302,16360,14011,-2291
ISNE,"2/8/2022 9 p.m. EST",15662,15570,13348,-2314
ISNE,"2/8/2022 10 p.m. EST",14828,14700,12556,-2272
ISNE,"2/8/2022 11 p.m. EST",13927,13690,11696,-2231
ISNE,"2/9/2022 12 a.m. EST",13137,12810,10899,-2238
ISNE,"2/9/2022 1 a.m. EST",12909,12300,10646,-2263
ISNE,"2/9/2022 2 a.m. EST",12647,12040,10188,-2459
ISNE,"2/9/2022 3 a.m. EST",12542,11960,10084,-2458
ISNE,"2/9/2022 4 a.m. EST",12618,12030,10188,-2430
ISNE,"2/9/2022 5 a.m. EST",12994,12420,10648,-2346
ISNE,"2/9/2022 6 a.m. EST",13488,13380,11219,-2269
ISNE,"2/9/2022 7 a.m. EST",14899,14940,12763,-2136
ISNE,"2/9/2022 8 a.m. EST",15610,15600,13542,-2068
ISNE,"2/9/2022 9 a.m. EST",14774,14740,12667,-2107
ISNE,"2/9/2022 10 a.m. EST",13598,13630,11500,-2098
ISNE,"2/9/2022 11 a.m. EST",12767,13090,10942,-1825
ISNE,"2/9/2022 12 p.m. EST",12534,12680,10697,-1837
ISNE,"2/9/2022 1 p.m. EST",12299,12200,10608,-1691
ISNE,"2/9/2022 2 p.m. EST",12549,12120,10884,-1665
ISNE,"2/9/2022 3 p.m. EST",12887,12530,11005,-1882
ISNE,"2/9/2022 4 p.m. EST",13348,13560,11329,-2019
ISNE,"2/9/2022 5 p.m. EST",14761,14780,12742,-2019
ISNE,"2/9/2022 6 p.m. EST",16159,16100,14151,-2008
ISNE,"2/9/2022 7 p.m. EST",16420,16470,14486,-1934
ISNE,"2/9/2022 8 p.m. EST",16050,15850,13978,-2072
ISNE,"2/9/2022 9 p.m. EST",15469,15440,13299,-2170
ISNE,"2/9/2022 10 p.m. EST",14690,14560,12575,-2115
ISNE,"2/9/2022 11 p.m. EST",13677,13620,11514,-2163
ISNE,"2/10/2022 12 a.m. EST",13052,12690,10857,-2195
ISNE,"2/10/2022 1 a.m. EST",12318,12210,10387,-1931
ISNE,"2/10/2022 2 a.m. EST",12233,11890,10139,-2094
ISNE,"2/10/2022 3 a.m. EST",12134,11800,10264,-1870
ISNE,"2/10/2022 4 a.m. EST",12190,11860,10294,-1896
ISNE,"2/10/2022 5 a.m. EST",12510,12190,10617,-1893
ISNE,"2/10/2022 6 a.m. EST",13078,13090,11245,-1833
ISNE,"2/10/2022 7 a.m. EST",14539,14580,12747,-1792
ISNE,"2/10/2022 8 a.m. EST",15286,15290,13519,-1767
ISNE,"2/10/2022 9 a.m. EST",15035,15030,13196,-1839
ISNE,"2/10/2022 10 a.m. EST",14337,14310,12552,-1785
ISNE,"2/10/2022 11 a.m. EST",13267,13770,11343,-1924
ISNE,"2/10/2022 12 p.m. EST",13113,13200,11063,-2050
ISNE,"2/10/2022 1 p.m. EST",13532,12730,11465,-2067
ISNE,"2/10/2022 2 p.m. EST",13614,12640,11538,-2076
ISNE,"2/10/2022 3 p.m. EST",13466,12880,11334,-2132
ISNE,"2/10/2022 4 p.m. EST",13701,13740,11669,-2032
ISNE,"2/10/2022 5 p.m. EST",14644,15070,12460,-2184
ISNE,"2/10/2022 6 p.m. EST",15775,16070,13427,-2348
ISNE,"2/10/2022 7 p.m. EST",16007,16200,13311,-2696
ISNE,"2/10/2022 8 p.m. EST",15586,15830,12590,-2996
ISNE,"2/10/2022 9 p.m. EST",15033,15190,11817,-3216
ISNE,"2/10/2022 10 p.m. EST",14364,14330,10906,-3458
ISNE,"2/10/2022 11 p.m. EST",13547,13290,10001,-3546
ISNE,"2/11/2022 12 a.m. EST",12925,12410,9439,-3486
ISNE,"2/11/2022 1 a.m. EST",12189,11700,8932,-3257
ISNE,"2/11/2022 2 a.m. EST",12272,11380,8864,-3408
ISNE,"2/11/2022 3 a.m. EST",12274,11260,8885,-3389
ISNE,"2/11/2022 4 a.m. EST",12152,11320,8700,-3452
ISNE,"2/11/2022 5 a.m. EST",12428,11730,9009,-3419
ISNE,"2/11/2022 6 a.m. EST",12868,12640,9504,-3364
ISNE,"2/11/2022 7 a.m. EST",14251,14120,10914,-3337
ISNE,"2/11/2022 8 a.m. EST",14945,14620,11444,-3501
ISNE,"2/11/2022 9 a.m. EST",14103,13970,10668,-3435
ISNE,"2/11/2022 10 a.m. EST",12877,13110,9518,-3359
ISNE,"2/11/2022 11 a.m. EST",12030,12480,9020,-3010
ISNE,"2/11/2022 12 p.m. EST",12046,11810,9064,-2982
ISNE,"2/11/2022 1 p.m. EST",12414,11500,9034,-3380
ISNE,"2/11/2022 2 p.m. EST",12122,11480,8961,-3161
ISNE,"2/11/2022 3 p.m. EST",11916,11750,9277,-2639
ISNE,"2/11/2022 4 p.m. EST",12528,12690,9797,-2731
ISNE,"2/11/2022 5 p.m. EST",13850,13910,10882,-2968
ISNE,"2/11/2022 6 p.m. EST",15015,15300,11723,-3292
ISNE,"2/11/2022 7 p.m. EST",15166,15550,11879,-3287
ISNE,"2/11/2022 8 p.m. EST",14729,14770,11296,-3433
ISNE,"2/11/2022 9 p.m. EST",14198,14150,10734,-3464
ISNE,"2/11/2022 10 p.m. EST",13548,13460,10094,-3454
ISNE,"2/11/2022 11 p.m. EST",12699,12590,9312,-3387
ISNE,"2/12/2022 12 a.m. EST",12100,11760,8676,-3424
ISNE,"2/12/2022 1 a.m. EST",11294,11190,8511,-2783
ISNE,"2/12/2022 2 a.m. EST",11116,10790,8415,-2701
ISNE,"2/12/2022 3 a.m. EST",10889,10560,8205,-2684
ISNE,"2/12/2022 4 a.m. EST",10787,10460,8090,-2697
ISNE,"2/12/2022 5 a.m. EST",10841,10500,7841,-3000
ISNE,"2/12/2022 6 a.m. EST",11208,10910,8014,-3194
ISNE,"2/12/2022 7 a.m. EST",11662,11580,8367,-3295
ISNE,"2/12/2022 8 a.m. EST",11965,11900,8639,-3326
ISNE,"2/12/2022 9 a.m. EST",12243,11890,8917,-3326
ISNE,"2/12/2022 10 a.m. EST",11988,11950,8731,-3257
ISNE,"2/12/2022 11 a.m. EST",11402,11400,8391,-3011
ISNE,"2/12/2022 12 p.m. EST",11013,10990,8196,-2817
ISNE,"2/12/2022 1 p.m. EST",10737,10850,8236,-2501
ISNE,"2/12/2022 2 p.m. EST",10732,10780,8525,-2207
ISNE,"2/12/2022 3 p.m. EST",10966,11130,8917,-2049
ISNE,"2/12/2022 4 p.m. EST",11644,11740,9462,-2182
ISNE,"2/12/2022 5 p.m. EST",12708,13020,10209,-2499
ISNE,"2/12/2022 6 p.m. EST",13911,14100,11272,-2639
ISNE,"2/12/2022 7 p.m. EST",14206,14300,11775,-2431
ISNE,"2/12/2022 8 p.m. EST",13884,13930,11433,-2451
ISNE,"2/12/2022 9 p.m. EST",13473,13590,10780,-2693
ISNE,"2/12/2022 10 p.m. EST",12978,13140,10408,-2570
ISNE,"2/12/2022 11 p.m. EST",12334,12490,9951,-2383
ISNE,"2/13/2022 12 a.m. EST",11646,11830,9333,-2313
ISNE,"2/13/2022 1 a.m. EST",11161,11400,9339,-1822
ISNE,"2/13/2022 2 a.m. EST",10869,11140,8956,-1913
ISNE,"2/13/2022 3 a.m. EST",10704,11090,8839,-1865
ISNE,"2/13/2022 4 a.m. EST",10699,11140,8546,-2153
ISNE,"2/13/2022 5 a.m. EST",10836,11260,8942,-1894
ISNE,"2/13/2022 6 a.m. EST",11221,11590,9159,-2062
ISNE,"2/13/2022 7 a.m. EST",11863,12110,9667,-2196
ISNE,"2/13/2022 8 a.m. EST",12619,12460,10466,-2153
ISNE,"2/13/2022 9 a.m. EST",13462,13010,11294,-2168
ISNE,"2/13/2022 10 a.m. EST",14108,13990,11534,-2574
ISNE,"2/13/2022 11 a.m. EST",14404,14220,11465,-2939
ISNE,"2/13/2022 12 p.m. EST",14564,14370,11426,-3138
ISNE,"2/13/2022 1 p.m. EST",14696,14320,11589,-3107
ISNE,"2/13/2022 2 p.m. EST",14752,14440,11705,-3047
ISNE,"2/13/2022 3 p.m. EST",14838,14530,11875,-2963
ISNE,"2/13/2022 4 p.m. EST",15129,14910,12215,-2914
ISNE,"2/13/2022 5 p.m. EST",15745,15770,12898,-2847
ISNE,"2/13/2022 6 p.m. EST",16628,16560,14201,-2427
ISNE,"2/13/2022 7 p.m. EST",16491,16600,14118,-2373
ISNE,"2/13/2022 8 p.m. EST",15755,16000,13485,-2270
ISNE,"2/13/2022 9 p.m. EST",15159,15470,12449,-2710
ISNE,"2/13/2022 10 p.m. EST",14605,14730,11820,-2785
ISNE,"2/13/2022 11 p.m. EST",13901,13900,10898,-3003
ISNE,"2/14/2022 12 a.m. EST",13089,13100,10007,-3082
ISNE,"2/14/2022 1 a.m. EST",12763,12510,9921,-2842
ISNE,"2/14/2022 2 a.m. EST",12816,12230,9906,-2910
ISNE,"2/14/2022 3 a.m. EST",12979,12150,10104,-2875
ISNE,"2/14/2022 4 a.m. EST",12867,12260,10085,-2782
ISNE,"2/14/2022 5 a.m. EST",13234,12690,10473,-2761
ISNE,"2/14/2022 6 a.m. EST",13660,13650,11566,-2094
ISNE,"2/14/2022 7 a.m. EST",15127,15180,13204,-1923
ISNE,"2/14/2022 8 a.m. EST",16222,16240,14912,-1310
ISNE,"2/14/2022 9 a.m. EST",16572,16600,15301,-1271
ISNE,"2/14/2022 10 a.m. EST",16455,16400,14415,-2040
ISNE,"2/14/2022 11 a.m. EST",16213,16090,14368,-1845
ISNE,"2/14/2022 12 p.m. EST",15937,15320,13919,-2018
ISNE,"2/14/2022 1 p.m. EST",15666,14850,13621,-2045
ISNE,"2/14/2022 2 p.m. EST",15706,14920,13617,-2089
ISNE,"2/14/2022 3 p.m. EST",15658,15100,13554,-2104
ISNE,"2/14/2022 4 p.m. EST",15818,15800,13812,-2006
ISNE,"2/14/2022 5 p.m. EST",16807,17090,14535,-2272
ISNE,"2/14/2022 6 p.m. EST",18018,18360,16220,-1798
ISNE,"2/14/2022 7 p.m. EST",18371,18650,16771,-1600
ISNE,"2/14/2022 8 p.m. EST",18045,18320,16149,-1896
ISNE,"2/14/2022 9 p.m. EST",17454,17630,15376,-2078
ISNE,"2/14/2022 10 p.m. EST",16627,16730,14371,-2256
ISNE,"2/14/2022 11 p.m. EST",15583,15580,13586,-1997
ISNE,"2/15/2022 12 a.m. EST",15060,14690,12837,-2223
ISNE,"2/15/2022 1 a.m. EST",14762,14160,12327,-2435
ISNE,"2/15/2022 2 a.m. EST",14477,13880,11762,-2715
ISNE,"2/15/2022 3 a.m. EST",14366,13780,11574,-2792
ISNE,"2/15/2022 4 a.m. EST",14177,13850,11690,-2487
ISNE,"2/15/2022 5 a.m. EST",14568,14260,11812,-2756
ISNE,"2/15/2022 6 a.m. EST",15220,15260,12354,-2866
ISNE,"2/15/2022 7 a.m. EST",16778,16820,13700,-3078
ISNE,"2/15/2022 8 a.m. EST",17589,17600,14456,-3133
ISNE,"2/15/2022 9 a.m. EST",17249,17240,14233,-3016
ISNE,"2/15/2022 10 a.m. EST",16631,16630,14004,-2627
ISNE,"2/15/2022 11 a.m. EST",16095,15810,13326,-2769
ISNE,"2/15/2022 12 p.m. EST",15948,15040,13104,-2844
ISNE,"2/15/2022 1 p.m. EST",15589,14620,12893,-2696
ISNE,"2/15/2022 2 p.m. EST",15638,14460,12971,-2667
ISNE,"2/15/2022 3 p.m. EST",15780,14630,13081,-2699
ISNE,"2/15/2022 4 p.m. EST",15821,15420,13030,-2791
ISNE,"2/15/2022 5 p.m. EST",16518,16680,13856,-2662
ISNE,"2/15/2022 6 p.m. EST",17752,18060,15251,-2501
ISNE,"2/15/2022 7 p.m. EST",18119,18120,15550,-2569
ISNE,"2/15/2022 8 p.m. EST",17785,17690,15012,-2773
ISNE,"2/15/2022 9 p.m. EST",17182,17260,14317,-2865
ISNE,"2/15/2022 10 p.m. EST",16343,16360,13416,-2927
ISNE,"2/15/2022 11 p.m. EST",15267,15390,12035,-3232
ISNE,"2/16/2022 12 a.m. EST",14387,14410,10852,-3535
ISNE,"2/16/2022 1 a.m. EST",13866,13860,10216,-3650
ISNE,"2/16/2022 2 a.m. EST",13822,13600,10394,-3428
ISNE,"2/16/2022 3 a.m. EST",13686,13520,10530,-3156
ISNE,"2/16/2022 4 a.m. EST",13585,13590,10273,-3312
ISNE,"2/16/2022 5 a.m. EST",13958,13960,10735,-3223
ISNE,"2/16/2022 6 a.m. EST",14896,14930,11449,-3447
ISNE,"2/16/2022 7 a.m. EST",16444,16460,13141,-3303
ISNE,"2/16/2022 8 a.m. EST",17117,17120,13784,-3333
ISNE,"2/16/2022 9 a.m. EST",16671,16620,13340,-3331
ISNE,"2/16/2022 10 a.m. EST",15896,15930,12528,-3368
ISNE,"2/16/2022 11 a.m. EST",15094,15180,12017,-3077
ISNE,"2/16/2022 12 p.m. EST",14525,14700,11649,-2876
ISNE,"2/16/2022 1 p.m. EST",14636,14380,11508,-3128
ISNE,"2/16/2022 2 p.m. EST",14659,14260,11528,-3131
ISNE,"2/16/2022 3 p.m. EST",15101,14330,11952,-3149
ISNE,"2/16/2022 4 p.m. EST",15487,14830,12308,-3179
ISNE,"2/16/2022 5 p.m. EST",15947,15620,12923,-3024
ISNE,"2/16/2022 6 p.m. EST",16857,16670,13944,-2913
ISNE,"2/16/2022 7 p.m. EST",16948,16820,13847,-3101
ISNE,"2/16/2022 8 p.m. EST",16378,16300,13268,-3110
ISNE,"2/16/2022 9 p.m. EST",15644,15600,12496,-3148
ISNE,"2/16/2022 10 p.m. EST",15191,14700,11720,-3471
ISNE,"2/16/2022 11 p.m. EST",14057,13550,10467,-3590
ISNE,"2/17/2022 12 a.m. EST",13349,12580,9746,-3603
ISNE,"2/17/2022 1 a.m. EST",12706,11810,9562,-3144
ISNE,"2/17/2022 2 a.m. EST",12276,11400,9138,-3138
ISNE,"2/17/2022 3 a.m. EST",12039,11160,9073,-2966
ISNE,"2/17/2022 4 a.m. EST",12001,11140,9013,-2988
ISNE,"2/17/2022 5 a.m. EST",12231,11390,9342,-2889
ISNE,"2/17/2022 6 a.m. EST",13024,12220,9871,-3153
ISNE,"2/17/2022 7 a.m. EST",13891,13620,10488,-3403
ISNE,"2/17/2022 8 a.m. EST",14229,14220,10858,-3371
ISNE,"2/17/2022 9 a.m. EST",13905,13830,10658,-3247
ISNE,"2/17/2022 10 a.m. EST",13708,13420,10550,-3158
ISNE,"2/17/2022 11 a.m. EST",13406,13250,10379,-3027
ISNE,"2/17/2022 12 p.m. EST",13243,12960,10311,-2932
ISNE,"2/17/2022 1 p.m. EST",13295,12800,10264,-3031
ISNE,"2/17/2022 2 p.m. EST",13697,12860,10710,-2987
ISNE,"2/17/2022 3 p.m. EST",14057,13090,11019,-3038
ISNE,"2/17/2022 4 p.m. EST",13965,13550,10928,-3037
ISNE,"2/17/2022 5 p.m. EST",14479,14490,11375,-3104
ISNE,"2/17/2022 6 p.m. EST",15176,15220,12021,-3155
ISNE,"2/17/2022 7 p.m. EST",15251,15330,12192,-3059
ISNE,"2/17/2022 8 p.m. EST",14757,14810,11902,-2855
ISNE,"2/17/2022 9 p.m. EST",14106,14070,11221,-2885
ISNE,"2/17/2022 10 p.m. EST",13244,13310,10502,-2742
ISNE,"2/17/2022 11 p.m. EST",12351,12260,9733,-2618
ISNE,"2/18/2022 12 a.m. EST",11558,11390,9355,-2203
ISNE,"2/18/2022 1 a.m. EST",11212,10670,9040,-2172
ISNE,"2/18/2022 2 a.m. EST",10905,10310,8851,-2054
ISNE,"2/18/2022 3 a.m. EST",10685,10110,8855,-1830
ISNE,"2/18/2022 4 a.m. EST",10653,10080,8827,-1826
ISNE,"2/18/2022 5 a.m. EST",10858,10310,8890,-1968
ISNE,"2/18/2022 6 a.m. EST",11412,11070,9210,-2202
ISNE,"2/18/2022 7 a.m. EST",12349,12380,9814,-2535
ISNE,"2/18/2022 8 a.m. EST",13305,13310,10280,-3025
ISNE,"2/18/2022 9 a.m. EST",13596,13580,10382,-3214
ISNE,"2/18/2022 10 a.m. EST",13308,13150,10156,-3152
ISNE,"2/18/2022 11 a.m. EST",12638,12360,9389,-3249
ISNE,"2/18/2022 12 p.m. EST",11818,11680,8775,-3043
ISNE,"2/18/2022 1 p.m. EST",11397,11340,8756,-2641
ISNE,"2/18/2022 2 p.m. EST",11497,11510,9239,-2258
ISNE,"2/18/2022 3 p.m. EST",11743,12090,9536,-2207
ISNE,"2/18/2022 4 p.m. EST",12559,12850,10566,-1993
ISNE,"2/18/2022 5 p.m. EST",14023,14510,11429,-2594
ISNE,"2/18/2022 6 p.m. EST",15411,15790,12480,-2931
ISNE,"2/18/2022 7 p.m. EST",15828,16100,12708,-3120
ISNE,"2/18/2022 8 p.m. EST",15534,15500,12360,-3174
ISNE,"2/18/2022 9 p.m. EST",15109,15040,11962,-3147
ISNE,"2/18/2022 10 p.m. EST",14555,14410,11491,-3064
ISNE,"2/18/2022 11 p.m. EST",13783,13680,10890,-2893
ISNE,"2/19/2022 12 a.m. EST",13045,12940,9981,-3064
ISNE,"2/19/2022 1 a.m. EST",12565,12540,9554,-3011
ISNE,"2/19/2022 2 a.m. EST",12520,12260,9427,-3093
ISNE,"2/19/2022 3 a.m. EST",12660,12170,9470,-3190
ISNE,"2/19/2022 4 a.m. EST",12702,12200,9435,-3267
ISNE,"2/19/2022 5 a.m. EST",12908,12410,9605,-3303
ISNE,"2/19/2022 6 a.m. EST",13330,12860,10083,-3247
ISNE,"2/19/2022 7 a.m. EST",13514,13530,10503,-3011
ISNE,"2/19/2022 8 a.m. EST",13757,13750,10834,-2923
ISNE,"2/19/2022 9 a.m. EST",13269,13250,10260,-3009
ISNE,"2/19/2022 10 a.m. EST",12931,12920,9914,-3017
ISNE,"2/19/2022 11 a.m. EST",12876,12860,9955,-2921
ISNE,"2/19/2022 12 p.m. EST",13173,13160,10172,-3001
ISNE,"2/19/2022 1 p.m. EST",13896,13850,10880,-3016
ISNE,"2/19/2022 2 p.m. EST",14517,13930,11605,-2912
ISNE,"2/19/2022 3 p.m. EST",14512,13960,11552,-2960
ISNE,"2/19/2022 4 p.m. EST",14633,14040,11638,-2995
ISNE,"2/19/2022 5 p.m. EST",14998,14580,11861,-3137
ISNE,"2/19/2022 6 p.m. EST",15833,15610,12715,-3118
ISNE,"2/19/2022 7 p.m. EST",16201,16150,13064,-3137
ISNE,"2/19/2022 8 p.m. EST",15904,15840,12756,-3148
ISNE,"2/19/2022 9 p.m. EST",15489,15530,12926,-2563
ISNE,"2/19/2022 10 p.m. EST",14942,14910,13067,-1875
ISNE,"2/19/2022 11 p.m. EST",14269,14160,11863,-2406
ISNE,"2/20/2022 12 a.m. EST",13772,13470,10685,-3087
ISNE,"2/20/2022 1 a.m. EST",13660,13150,11029,-2631
ISNE,"2/20/2022 2 a.m. EST",13401,12880,10936,-2465
ISNE,"2/20/2022 3 a.m. EST",13287,12780,10827,-2460
ISNE,"2/20/2022 4 a.m. EST",12800,12760,10720,-2080
ISNE,"2/20/2022 5 a.m. EST",12879,12900,10813,-2066
ISNE,"2/20/2022 6 a.m. EST",13197,13210,11138,-2059
ISNE,"2/20/2022 7 a.m. EST",13696,13710,11473,-2223
ISNE,"2/20/2022 8 a.m. EST",13919,13910,11360,-2559
ISNE,"2/20/2022 9 a.m. EST",13474,13460,10834,-2640
ISNE,"2/20/2022 10 a.m. EST",12799,12750,10034,-2765
ISNE,"2/20/2022 11 a.m. EST",12577,12100,9726,-2851
ISNE,"2/20/2022 12 p.m. EST",12608,11750,9775,-2833
ISNE,"2/20/2022 1 p.m. EST",12502,11710,9706,-2796
ISNE,"2/20/2022 2 p.m. EST",12289,11870,9165,-3124
ISNE,"2/20/2022 3 p.m. EST",12421,12560,9211,-3210
ISNE,"2/20/2022 4 p.m. EST",12988,13310,9829,-3159
ISNE,"2/20/2022 5 p.m. EST",14391,14530,11393,-2998
ISNE,"2/20/2022 6 p.m. EST",15837,15910,12911,-2926
ISNE,"2/20/2022 7 p.m. EST",16285,16390,13409,-2876
ISNE,"2/20/2022 8 p.m. EST",15912,16030,12996,-2916
ISNE,"2/20/2022 9 p.m. EST",15357,15540,12335,-3022
ISNE,"2/20/2022 10 p.m. EST",14625,14820,11672,-2953
ISNE,"2/20/2022 11 p.m. EST",13708,13870,10343,-3365
ISNE,"2/21/2022 12 a.m. EST",13075,13040,9658,-3417
ISNE,"2/21/2022 1 a.m. EST",12451,12310,9564,-2887
ISNE,"2/21/2022 2 a.m. EST",11966,11960,9369,-2597
ISNE,"2/21/2022 3 a.m. EST",11796,11800,9122,-2674
ISNE,"2/21/2022 4 a.m. EST",11783,11780,9029,-2754
ISNE,"2/21/2022 5 a.m. EST",12032,12050,9077,-2955
ISNE,"2/21/2022 6 a.m. EST",12693,12710,10050,-2643
ISNE,"2/21/2022 7 a.m. EST",13621,13660,10543,-3078
ISNE,"2/21/2022 8 a.m. EST",13987,14010,11079,-2908
ISNE,"2/21/2022 9 a.m. EST",13483,13490,10420,-3063
ISNE,"2/21/2022 10 a.m. EST",12637,12330,9585,-3052
ISNE,"2/21/2022 11 a.m. EST",12164,12040,9173,-2991
ISNE,"2/21/2022 12 p.m. EST",11886,11710,9287,-2599
ISNE,"2/21/2022 1 p.m. EST",11788,11480,9322,-2466
ISNE,"2/21/2022 2 p.m. EST",11604,11520,9183,-2421
ISNE,"2/21/2022 3 p.m. EST",11757,11830,9241,-2516
ISNE,"2/21/2022 4 p.m. EST",12437,12720,9440,-2997
ISNE,"2/21/2022 5 p.m. EST",13566,13830,10109,-3457
ISNE,"2/21/2022 6 p.m. EST",14825,15300,11319,-3506
ISNE,"2/21/2022 7 p.m. EST",15328,15750,11746,-3582
ISNE,"2/21/2022 8 p.m. EST",14885,15300,11246,-3639
ISNE,"2/21/2022 9 p.m. EST",14387,14670,10778,-3609
ISNE,"2/21/2022 10 p.m. EST",13858,13810,10103,-3755
ISNE,"2/21/2022 11 p.m. EST",12953,12850,9508,-3445
ISNE,"2/22/2022 12 a.m. EST",12152,12000,8993,-3159
ISNE,"2/22/2022 1 a.m. EST",11656,11380,8680,-2976
ISNE,"2/22/2022 2 a.m. EST",11551,11130,8631,-2920
ISNE,"2/22/2022 3 a.m. EST",11576,11050,8726,-2850
ISNE,"2/22/2022 4 a.m. EST",11927,11160,8910,-3017
ISNE,"2/22/2022 5 a.m. EST",11833,11530,9025,-2808
ISNE,"2/22/2022 6 a.m. EST",12658,12430,9561,-3097
ISNE,"2/22/2022 7 a.m. EST",13672,13690,10546,-3126
ISNE,"2/22/2022 8 a.m. EST",14303,14300,11210,-3093
ISNE,"2/22/2022 9 a.m. EST",14266,14250,11296,-2970
ISNE,"2/22/2022 10 a.m. EST",14108,14100,11197,-2911
ISNE,"2/22/2022 11 a.m. EST",13943,13930,11135,-2808
ISNE,"2/22/2022 12 p.m. EST",14245,14250,11680,-2565
ISNE,"2/22/2022 1 p.m. EST",14542,14530,11952,-2590
ISNE,"2/22/2022 2 p.m. EST",14723,14710,12207,-2516
ISNE,"2/22/2022 3 p.m. EST",14849,14710,12428,-2421
ISNE,"2/22/2022 4 p.m. EST",15001,14810,12436,-2565
ISNE,"2/22/2022 5 p.m. EST",15386,15110,12614,-2772
ISNE,"2/22/2022 6 p.m. EST",15960,15550,13013,-2947
ISNE,"2/22/2022 7 p.m. EST",15840,15750,13053,-2787
ISNE,"2/22/2022 8 p.m. EST",15217,15000,12395,-2822
ISNE,"2/22/2022 9 p.m. EST",14474,14290,11777,-2697
ISNE,"2/22/2022 10 p.m. EST",13528,13360,10781,-2747
ISNE,"2/22/2022 11 p.m. EST",12771,12270,9620,-3151
ISNE,"2/23/2022 12 a.m. EST",11970,11370,8784,-3186
ISNE,"2/23/2022 1 a.m. EST",11306,10770,8451,-2855
ISNE,"2/23/2022 2 a.m. EST",10854,10330,8366,-2488
ISNE,"2/23/2022 3 a.m. EST",10375,10110,8557,-1818
ISNE,"2/23/2022 4 a.m. EST",10306,10050,8654,-1652
ISNE,"2/23/2022 5 a.m. EST",10654,10320,8923,-1731
ISNE,"2/23/2022 6 a.m. EST",11482,11090,9091,-2391
ISNE,"2/23/2022 7 a.m. EST",12307,12330,9558,-2749
ISNE,"2/23/2022 8 a.m. EST",13096,13110,9903,-3193
ISNE,"2/23/2022 9 a.m. EST",13288,13280,10289,-2999
ISNE,"2/23/2022 10 a.m. EST",13023,12850,10161,-2862
ISNE,"2/23/2022 11 a.m. EST",12412,12580,9510,-2902
ISNE,"2/23/2022 12 p.m. EST",12035,12360,9354,-2681
ISNE,"2/23/2022 1 p.m. EST",11882,12230,9237,-2645
ISNE,"2/23/2022 2 p.m. EST",11855,12260,9193,-2662
ISNE,"2/23/2022 3 p.m. EST",11591,12550,9054,-2537
ISNE,"2/23/2022 4 p.m. EST",12175,12870,9773,-2402
ISNE,"2/23/2022 5 p.m. EST",13002,13520,10379,-2623
ISNE,"2/23/2022 6 p.m. EST",14301,14720,11279,-3022
ISNE,"2/23/2022 7 p.m. EST",14900,15150,12116,-2784
ISNE,"2/23/2022 8 p.m. EST",14668,14820,12112,-2556
ISNE,"2/23/2022 9 p.m. EST",14249,14350,12074,-2175
ISNE,"2/23/2022 10 p.m. EST",13646,13640,11123,-2523
ISNE,"2/23/2022 11 p.m. EST",13109,12680,10391,-2718
ISNE,"2/24/2022 12 a.m. EST",12378,11870,9891,-2487
ISNE,"2/24/2022 1 a.m. EST",11907,11640,9587,-2320
ISNE,"2/24/2022 2 a.m. EST",11689,11440,9241,-2448
ISNE,"2/24/2022 3 a.m. EST",11636,11380,9386,-2250
ISNE,"2/24/2022 4 a.m. EST",11720,11530,9497,-2223
ISNE,"2/24/2022 5 a.m. EST",11958,11970,9441,-2517
ISNE,"2/24/2022 6 a.m. EST",12889,12920,10034,-2855
ISNE,"2/24/2022 7 a.m. EST",14261,14280,11525,-2736
ISNE,"2/24/2022 8 a.m. EST",15066,15070,12420,-2646
ISNE,"2/24/2022 9 a.m. EST",15095,15090,12421,-2674
ISNE,"2/24/2022 10 a.m. EST",14819,14810,11995,-2824
ISNE,"2/24/2022 11 a.m. EST",14650,14640,11141,-3509
ISNE,"2/24/2022 12 p.m. EST",14416,14400,10897,-3519
ISNE,"2/24/2022 1 p.m. EST",14495,14490,10717,-3778
ISNE,"2/24/2022 2 p.m. EST",14852,14820,11081,-3771
ISNE,"2/24/2022 3 p.m. EST",14936,15080,11059,-3877
ISNE,"2/24/2022 4 p.m. EST",14923,15250,11078,-3845
ISNE,"2/24/2022 5 p.m. EST",15363,15870,11571,-3792
ISNE,"2/24/2022 6 p.m. EST",16429,16640,12864,-3565
ISNE,"2/24/2022 7 p.m. EST",16815,16900,13227,-3588
ISNE,"2/24/2022 8 p.m. EST",16432,16470,12797,-3635
ISNE,"2/24/2022 9 p.m. EST",15849,15830,12134,-3715
ISNE,"2/24/2022 10 p.m. EST",15085,15020,11384,-3701
ISNE,"2/24/2022 11 p.m. EST",14169,14020,10488,-3681
ISNE,"2/25/2022 12 a.m. EST",13304,13130,9569,-3735
ISNE,"2/25/2022 1 a.m. EST",12770,12470,9161,-3609
ISNE,"2/25/2022 2 a.m. EST",12527,12140,9204,-3323
ISNE,"2/25/2022 3 a.m. EST",12350,11960,8955,-3395
ISNE,"2/25/2022 4 a.m. EST",12391,12000,9128,-3263
ISNE,"2/25/2022 5 a.m. EST",12495,12350,9255,-3240
ISNE,"2/25/2022 6 a.m. EST",13153,13120,9832,-3321
ISNE,"2/25/2022 7 a.m. EST",14129,14250,10680,-3449
ISNE,"2/25/2022 8 a.m. EST",14991,15120,11559,-3432
ISNE,"2/25/2022 9 a.m. EST",15819,15830,12736,-3083
ISNE,"2/25/2022 10 a.m. EST",16348,16400,13419,-2929
ISNE,"2/25/2022 11 a.m. EST",16703,16680,13740,-2963
ISNE,"2/25/2022 12 p.m. EST",16841,16730,13780,-3061
ISNE,"2/25/2022 1 p.m. EST",16799,16630,14089,-2710
ISNE,"2/25/2022 2 p.m. EST",16598,16590,13822,-2776
ISNE,"2/25/2022 3 p.m. EST",16313,16520,13489,-2824
ISNE,"2/25/2022 4 p.m. EST",16152,16500,13052,-3100
ISNE,"2/25/2022 5 p.m. EST",16387,16750,13409,-2978
ISNE,"2/25/2022 6 p.m. EST",17038,17140,14214,-2824
ISNE,"2/25/2022 7 p.m. EST",17180,17200,14440,-2740
ISNE,"2/25/2022 8 p.m. EST",16630,16590,13651,-2979
ISNE,"2/25/2022 9 p.m. EST",16008,15920,12976,-3032
ISNE,"2/25/2022 10 p.m. EST",15279,15280,11942,-3337
ISNE,"2/25/2022 11 p.m. EST",14421,14470,11034,-3387
ISNE,"2/26/2022 12 a.m. EST",13669,13670,10140,-3529
ISNE,"2/26/2022 1 a.m. EST",13343,13110,9678,-3665
ISNE,"2/26/2022 2 a.m. EST",13075,12800,9596,-3479
ISNE,"2/26/2022 3 a.m. EST",12952,12680,9469,-3483
ISNE,"2/26/2022 4 a.m. EST",12970,12710,9426,-3544
ISNE,"2/26/2022 5 a.m. EST",13174,12920,9636,-3538
ISNE,"2/26/2022 6 a.m. EST",13618,13370,9987,-3631
ISNE,"2/26/2022 7 a.m. EST",14131,14010,10640,-3491
ISNE,"2/26/2022 8 a.m. EST",14821,14630,11483,-3338
ISNE,"2/26/2022 9 a.m. EST",15015,15020,11947,-3068
ISNE,"2/26/2022 10 a.m. EST",15049,15020,11945,-3104
ISNE,"2/26/2022 11 a.m. EST",14800,14770,11689,-3111
ISNE,"2/26/2022 12 p.m. EST",14369,14360,11096,-3273
ISNE,"2/26/2022 1 p.m. EST",14068,13840,10707,-3361
ISNE,"2/26/2022 2 p.m. EST",13641,13440,10193,-3448
ISNE,"2/26/2022 3 p.m. EST",13447,13330,10001,-3446
ISNE,"2/26/2022 4 p.m. EST",13732,13740,10372,-3360
ISNE,"2/26/2022 5 p.m. EST",14259,14660,11007,-3252
ISNE,"2/26/2022 6 p.m. EST",15355,15840,12008,-3347
ISNE,"2/26/2022 7 p.m. EST",15914,16330,12597,-3317
ISNE,"2/26/2022 8 p.m. EST",15606,15960,12316,-3290
ISNE,"2/26/2022 9 p.m. EST",15141,15510,11810,-3331
ISNE,"2/26/2022 10 p.m. EST",14599,14940,11085,-3514
ISNE,"2/26/2022 11 p.m. EST",13899,14230,10334,-3565
ISNE,"2/27/2022 12 a.m. EST",13459,13520,9862,-3597
ISNE,"2/27/2022 1 a.m. EST",12963,12690,9445,-3518
ISNE,"2/27/2022 2 a.m. EST",12886,12370,9372,-3514
ISNE,"2/27/2022 3 a.m. EST",12762,12230,9224,-3538
ISNE,"2/27/2022 4 a.m. EST",12739,12230,9144,-3595
ISNE,"2/27/2022 5 a.m. EST",12623,12330,9199,-3424
ISNE,"2/27/2022 6 a.m. EST",12641,12640,9139,-3502
ISNE,"2/27/2022 7 a.m. EST",13085,13090,9542,-3543
ISNE,"2/27/2022 8 a.m. EST",13322,13320,9780,-3542
ISNE,"2/27/2022 9 a.m. EST",13269,13250,9783,-3486
ISNE,"2/27/2022 10 a.m. EST",13105,13010,9613,-3492
ISNE,"2/27/2022 11 a.m. EST",12962,12720,9499,-3463
ISNE,"2/27/2022 12 p.m. EST",12948,12390,9478,-3470
ISNE,"2/27/2022 1 p.m. EST",12784,12200,9497,-3287
ISNE,"2/27/2022 2 p.m. EST",12778,12140,9355,-3423
ISNE,"2/27/2022 3 p.m. EST",12872,12340,9547,-3325
ISNE,"2/27/2022 4 p.m. EST",13367,13260,9941,-3426
ISNE,"2/27/2022 5 p.m. EST",14184,14520,10513,-3671
ISNE,"2/27/2022 6 p.m. EST",15316,15620,11668,-3648
ISNE,"2/27/2022 7 p.m. EST",15913,16050,12284,-3629
ISNE,"2/27/2022 8 p.m. EST",15588,15640,12021,-3567
ISNE,"2/27/2022 9 p.m. EST",15052,15150,11375,-3677
ISNE,"2/27/2022 10 p.m. EST",14354,14470,10602,-3752
ISNE,"2/27/2022 11 p.m. EST",13541,13660,9791,-3750
ISNE,"2/28/2022 12 a.m. EST",13291,12940,9542,-3749
ISNE,"2/28/2022 1 a.m. EST",12858,12330,9100,-3758
ISNE,"2/28/2022 2 a.m. EST",12656,12130,9033,-3623
ISNE,"2/28/2022 3 a.m. EST",12618,12090,8940,-3678
ISNE,"2/28/2022 4 a.m. EST",12493,12250,9077,-3416
ISNE,"2/28/2022 5 a.m. EST",12932,12740,9584,-3348
ISNE,"2/28/2022 6 a.m. EST",13706,13870,10192,-3514
ISNE,"2/28/2022 7 a.m. EST",15231,15490,11766,-3465
ISNE,"2/28/2022 8 a.m. EST",15792,15910,12352,-3440
ISNE,"2/28/2022 9 a.m. EST",15291,15370,11961,-3330
ISNE,"2/28/2022 10 a.m. EST",14594,14450,11158,-3436
ISNE,"2/28/2022 11 a.m. EST",14159,13810,10837,-3322
ISNE,"2/28/2022 12 p.m. EST",13859,13470,10564,-3295
ISNE,"2/28/2022 1 p.m. EST",13564,13220,10342,-3222
ISNE,"2/28/2022 2 p.m. EST",13407,13300,9975,-3432
ISNE,"2/28/2022 3 p.m. EST",13460,13600,10756,-2704
ISNE,"2/28/2022 4 p.m. EST",14113,14630,11223,-2890
ISNE,"2/28/2022 5 p.m. EST",15414,15910,12147,-3267
ISNE,"2/28/2022 6 p.m. EST",16893,17390,13801,-3092
ISNE,"2/28/2022 7 p.m. EST",17490,18000,14676,-2814
ISNE,"2/28/2022 8 p.m. EST",17147,17570,13908,-3239
ISNE,"2/28/2022 9 p.m. EST",16547,16890,13010,-3537
ISNE,"2/28/2022 10 p.m. EST",15710,16060,12137,-3573
ISNE,"2/28/2022 11 p.m. EST",14695,15000,11047,-3648
ISNE,"3/1/2022 12 a.m. EST",13856,14160,10237,-3619
