"BA Code","Timestamp (Hour Ending)","Demand (MWh)","Demand Forecast (MWh)","Net Generation (MWh)","Total Interchange (MWh)"
NEVP,"12/1/2022 12 a.m. PST",3825,3703,3290,-535
NEVP,"12/1/2022 1 a.m. PST",3724,3532,3253,-471
NEVP,"12/1/2022 2 a.m. PST",3677,3487,3259,-418
NEVP,"12/1/2022 3 a.m. PST",3652,3489,3097,-555
NEVP,"12/1/2022 4 a.m. PST",3682,3509,3089,-593
NEVP,"12/1/2022 5 a.m. PST",3779,3582,3135,-644
NEVP,"12/1/2022 6 a.m. PST",3966,3736,3090,-876
NEVP,"12/1/2022 7 a.m. PST",4143,3903,3137,-1006
NEVP,"12/1/2022 8 a.m. PST",4171,3873,3383,-788
NEVP,"12/1/2022 9 a.m. PST",4142,3868,3161,-981
NEVP,"12/1/2022 10 a.m. PST",4122,3801,3226,-896
NEVP,"12/1/2022 11 a.m. PST",4001,3717,3542,-459
NEVP,"12/1/2022 12 p.m. PST",3996,3675,3357,-639
NEVP,"12/1/2022 1 p.m. PST",3985,3676,3243,-742
NEVP,"12/1/2022 2 p.m. PST",3907,3636,3636,-271
NEVP,"12/1/2022 3 p.m. PST",3964,3665,3537,-427
NEVP,"12/1/2022 4 p.m. PST",4108,3775,3417,-691
NEVP,"12/1/2022 5 p.m. PST",4342,3987,3688,-654
NEVP,"12/1/2022 6 p.m. PST",4477,4104,3742,-735
NEVP,"12/1/2022 7 p.m. PST",4452,4102,4031,-421
NEVP,"12/1/2022 8 p.m. PST",4401,4032,4023,-378
NEVP,"12/1/2022 9 p.m. PST",4316,3980,3727,-589
NEVP,"12/1/2022 10 p.m. PST",4171,3918,3610,-561
NEVP,"12/1/2022 11 p.m. PST",3972,3794,3267,-705
NEVP,"12/2/2022 12 a.m. PST",3826,3637,3082,-744
NEVP,"12/2/2022 1 a.m. PST",3704,3497,2987,-717
NEVP,"12/2/2022 2 a.m. PST",3645,3449,2975,-670
NEVP,"12/2/2022 3 a.m. PST",3602,3410,3023,-579
NEVP,"12/2/2022 4 a.m. PST",3599,3434,3022,-577
NEVP,"12/2/2022 5 a.m. PST",3659,3492,3202,-457
NEVP,"12/2/2022 6 a.m. PST",3818,3620,3388,-430
NEVP,"12/2/2022 7 a.m. PST",3990,3827,3452,-538
NEVP,"12/2/2022 8 a.m. PST",4001,3775,3495,-506
NEVP,"12/2/2022 9 a.m. PST",3948,3729,4060,112
NEVP,"12/2/2022 10 a.m. PST",3879,3728,4155,276
NEVP,"12/2/2022 11 a.m. PST",3904,3658,4116,212
NEVP,"12/2/2022 12 p.m. PST",3826,3595,3859,33
NEVP,"12/2/2022 1 p.m. PST",3801,3613,3894,93
NEVP,"12/2/2022 2 p.m. PST",3807,3566,3807,0
NEVP,"12/2/2022 3 p.m. PST",3832,3629,3720,-112
NEVP,"12/2/2022 4 p.m. PST",3929,3758,3878,-51
NEVP,"12/2/2022 5 p.m. PST",4174,3943,3904,-270
NEVP,"12/2/2022 6 p.m. PST",4331,4095,4107,-224
NEVP,"12/2/2022 7 p.m. PST",4304,4084,3973,-331
NEVP,"12/2/2022 8 p.m. PST",4264,4063,3878,-386
NEVP,"12/2/2022 9 p.m. PST",4200,3944,3677,-523
NEVP,"12/2/2022 10 p.m. PST",4105,3872,3494,-611
NEVP,"12/2/2022 11 p.m. PST",3976,3737,3386,-590
NEVP,"12/3/2022 12 a.m. PST",3830,3616,3312,-518
NEVP,"12/3/2022 1 a.m. PST",3715,3544,3282,-433
NEVP,"12/3/2022 2 a.m. PST",3635,3478,3182,-453
NEVP,"12/3/2022 3 a.m. PST",3593,3450,3168,-425
NEVP,"12/3/2022 4 a.m. PST",3581,3474,3152,-429
NEVP,"12/3/2022 5 a.m. PST",3609,3476,3018,-591
NEVP,"12/3/2022 6 a.m. PST",3682,3537,3049,-633
NEVP,"12/3/2022 7 a.m. PST",3758,3631,3087,-671
NEVP,"12/3/2022 8 a.m. PST",3795,3602,3153,-642
NEVP,"12/3/2022 9 a.m. PST",3786,3609,3349,-437
NEVP,"12/3/2022 10 a.m. PST",3807,3637,3747,-60
NEVP,"12/3/2022 11 a.m. PST",3749,3558,3833,84
NEVP,"12/3/2022 12 p.m. PST",3689,3513,3687,-2
NEVP,"12/3/2022 1 p.m. PST",3674,3546,3700,26
NEVP,"12/3/2022 2 p.m. PST",3664,3534,3863,199
NEVP,"12/3/2022 3 p.m. PST",3706,3596,3921,215
NEVP,"12/3/2022 4 p.m. PST",3841,3694,3730,-111
NEVP,"12/3/2022 5 p.m. PST",4085,3906,3587,-498
NEVP,"12/3/2022 6 p.m. PST",4227,4047,3629,-598
NEVP,"12/3/2022 7 p.m. PST",4180,4049,3698,-482
NEVP,"12/3/2022 8 p.m. PST",4142,3998,3732,-410
NEVP,"12/3/2022 9 p.m. PST",4085,3944,3686,-399
NEVP,"12/3/2022 10 p.m. PST",3994,3855,3560,-434
NEVP,"12/3/2022 11 p.m. PST",3881,3732,3482,-399
NEVP,"12/4/2022 12 a.m. PST",3752,3607,3280,-472
NEVP,"12/4/2022 1 a.m. PST",3624,3470,3303,-321
NEVP,"12/4/2022 2 a.m. PST",3554,3428,3330,-224
NEVP,"12/4/2022 3 a.m. PST",3515,3393,3347,-168
NEVP,"12/4/2022 4 a.m. PST",3511,3369,3356,-155
NEVP,"12/4/2022 5 a.m. PST",3551,3396,3372,-179
NEVP,"12/4/2022 6 a.m. PST",3613,3459,3300,-313
NEVP,"12/4/2022 7 a.m. PST",3682,3523,3217,-465
NEVP,"12/4/2022 8 a.m. PST",3645,3515,3221,-424
NEVP,"12/4/2022 9 a.m. PST",3697,3526,3185,-512
NEVP,"12/4/2022 10 a.m. PST",3674,3567,2986,-688
NEVP,"12/4/2022 11 a.m. PST",3661,3570,3215,-446
NEVP,"12/4/2022 12 p.m. PST",3624,3513,3056,-568
NEVP,"12/4/2022 1 p.m. PST",3611,3510,3261,-350
NEVP,"12/4/2022 2 p.m. PST",3648,3523,3430,-218
NEVP,"12/4/2022 3 p.m. PST",3727,3611,3517,-210
NEVP,"12/4/2022 4 p.m. PST",3860,3756,3429,-431
NEVP,"12/4/2022 5 p.m. PST",4085,3932,3416,-669
NEVP,"12/4/2022 6 p.m. PST",4240,4090,3868,-372
NEVP,"12/4/2022 7 p.m. PST",4212,4114,3843,-369
NEVP,"12/4/2022 8 p.m. PST",4158,4049,3835,-323
NEVP,"12/4/2022 9 p.m. PST",4089,4018,3857,-232
NEVP,"12/4/2022 10 p.m. PST",3962,3902,3807,-155
NEVP,"12/4/2022 11 p.m. PST",3808,3766,3612,-196
NEVP,"12/5/2022 12 a.m. PST",3641,3606,3436,-205
NEVP,"12/5/2022 1 a.m. PST",3513,3485,3293,-220
NEVP,"12/5/2022 2 a.m. PST",3472,3439,3153,-319
NEVP,"12/5/2022 3 a.m. PST",3448,3400,2943,-505
NEVP,"12/5/2022 4 a.m. PST",3459,3437,2905,-554
NEVP,"12/5/2022 5 a.m. PST",3542,3504,2927,-615
NEVP,"12/5/2022 6 a.m. PST",3699,3698,3124,-575
NEVP,"12/5/2022 7 a.m. PST",3897,3892,3239,-658
NEVP,"12/5/2022 8 a.m. PST",3963,3932,3251,-712
NEVP,"12/5/2022 9 a.m. PST",3994,3888,3690,-304
NEVP,"12/5/2022 10 a.m. PST",4024,3812,3848,-176
NEVP,"12/5/2022 11 a.m. PST",3977,3791,3736,-241
NEVP,"12/5/2022 12 p.m. PST",3912,3657,3609,-303
NEVP,"12/5/2022 1 p.m. PST",3832,3657,3575,-257
NEVP,"12/5/2022 2 p.m. PST",3842,3666,3394,-448
NEVP,"12/5/2022 3 p.m. PST",3865,3834,3544,-321
NEVP,"12/5/2022 4 p.m. PST",3923,3877,3441,-482
NEVP,"12/5/2022 5 p.m. PST",4192,4143,3874,-318
NEVP,"12/5/2022 6 p.m. PST",4375,4320,4009,-366
NEVP,"12/5/2022 7 p.m. PST",4377,4299,4023,-354
NEVP,"12/5/2022 8 p.m. PST",4350,4266,3977,-373
NEVP,"12/5/2022 9 p.m. PST",4274,4215,3905,-369
NEVP,"12/5/2022 10 p.m. PST",4130,4085,3747,-383
NEVP,"12/5/2022 11 p.m. PST",3950,3882,3465,-485
NEVP,"12/6/2022 12 a.m. PST",3806,3709,3355,-451
NEVP,"12/6/2022 1 a.m. PST",3690,3534,3148,-542
NEVP,"12/6/2022 2 a.m. PST",3631,3487,3217,-414
NEVP,"12/6/2022 3 a.m. PST",3606,3471,3268,-338
NEVP,"12/6/2022 4 a.m. PST",3619,3504,3284,-335
NEVP,"12/6/2022 5 a.m. PST",3695,3605,3323,-372
NEVP,"12/6/2022 6 a.m. PST",3879,3773,3244,-635
NEVP,"12/6/2022 7 a.m. PST",4076,3932,3360,-716
NEVP,"12/6/2022 8 a.m. PST",4154,3933,3450,-704
NEVP,"12/6/2022 9 a.m. PST",4047,3909,3657,-390
NEVP,"12/6/2022 10 a.m. PST",3886,3868,3696,-190
NEVP,"12/6/2022 11 a.m. PST",3859,3812,3523,-336
NEVP,"12/6/2022 12 p.m. PST",3830,3791,3370,-460
NEVP,"12/6/2022 1 p.m. PST",3811,3768,3485,-326
NEVP,"12/6/2022 2 p.m. PST",3876,3774,3585,-291
NEVP,"12/6/2022 3 p.m. PST",3898,3794,3516,-382
NEVP,"12/6/2022 4 p.m. PST",3993,3877,3357,-636
NEVP,"12/6/2022 5 p.m. PST",4238,4080,3459,-779
NEVP,"12/6/2022 6 p.m. PST",4403,4259,3736,-667
NEVP,"12/6/2022 7 p.m. PST",4402,4257,3785,-617
NEVP,"12/6/2022 8 p.m. PST",4378,4215,3866,-512
NEVP,"12/6/2022 9 p.m. PST",4312,4159,3881,-431
NEVP,"12/6/2022 10 p.m. PST",4163,4016,3643,-520
NEVP,"12/6/2022 11 p.m. PST",4003,3854,3377,-626
NEVP,"12/7/2022 12 a.m. PST",3858,3692,3347,-511
NEVP,"12/7/2022 1 a.m. PST",3756,3544,3248,-508
NEVP,"12/7/2022 2 a.m. PST",3714,3522,3218,-496
NEVP,"12/7/2022 3 a.m. PST",3694,3528,3376,-318
NEVP,"12/7/2022 4 a.m. PST",3708,3557,3262,-446
NEVP,"12/7/2022 5 a.m. PST",3793,3622,3385,-408
NEVP,"12/7/2022 6 a.m. PST",3986,3784,3502,-484
NEVP,"12/7/2022 7 a.m. PST",4185,3956,3479,-706
NEVP,"12/7/2022 8 a.m. PST",4217,3984,3588,-629
NEVP,"12/7/2022 9 a.m. PST",4099,3944,3650,-449
NEVP,"12/7/2022 10 a.m. PST",3975,3907,3612,-363
NEVP,"12/7/2022 11 a.m. PST",3907,3804,3568,-339
NEVP,"12/7/2022 12 p.m. PST",3862,3812,3456,-406
NEVP,"12/7/2022 1 p.m. PST",3922,3746,3458,-464
NEVP,"12/7/2022 2 p.m. PST",3946,3699,3474,-472
NEVP,"12/7/2022 3 p.m. PST",3924,3734,3787,-137
NEVP,"12/7/2022 4 p.m. PST",4009,3830,3658,-351
NEVP,"12/7/2022 5 p.m. PST",4318,4070,3432,-886
NEVP,"12/7/2022 6 p.m. PST",4467,4304,3717,-750
NEVP,"12/7/2022 7 p.m. PST",4470,4265,3783,-687
NEVP,"12/7/2022 8 p.m. PST",4464,4210,3944,-520
NEVP,"12/7/2022 9 p.m. PST",4390,4183,4015,-375
NEVP,"12/7/2022 10 p.m. PST",4242,4066,3947,-295
NEVP,"12/7/2022 11 p.m. PST",4100,3870,3808,-292
NEVP,"12/8/2022 12 a.m. PST",3961,3759,3732,-229
NEVP,"12/8/2022 1 a.m. PST",3856,3628,3339,-517
NEVP,"12/8/2022 2 a.m. PST",3800,3602,3296,-504
NEVP,"12/8/2022 3 a.m. PST",3783,3614,3307,-476
NEVP,"12/8/2022 4 a.m. PST",3811,3667,3330,-481
NEVP,"12/8/2022 5 a.m. PST",3920,3808,3302,-618
NEVP,"12/8/2022 6 a.m. PST",4106,3951,3470,-636
NEVP,"12/8/2022 7 a.m. PST",4313,4003,3534,-779
NEVP,"12/8/2022 8 a.m. PST",4297,4081,3754,-543
NEVP,"12/8/2022 9 a.m. PST",4166,4007,3774,-392
NEVP,"12/8/2022 10 a.m. PST",4100,3847,3827,-273
NEVP,"12/8/2022 11 a.m. PST",4007,3751,3772,-235
NEVP,"12/8/2022 12 p.m. PST",3943,3668,3796,-147
NEVP,"12/8/2022 1 p.m. PST",3909,3615,3779,-130
NEVP,"12/8/2022 2 p.m. PST",3904,3690,3792,-112
NEVP,"12/8/2022 3 p.m. PST",3937,3721,3881,-56
NEVP,"12/8/2022 4 p.m. PST",4045,3917,3511,-534
NEVP,"12/8/2022 5 p.m. PST",4326,4127,3640,-686
NEVP,"12/8/2022 6 p.m. PST",4500,4339,3958,-542
NEVP,"12/8/2022 7 p.m. PST",4507,4309,4185,-322
NEVP,"12/8/2022 8 p.m. PST",4473,4243,4391,-82
NEVP,"12/8/2022 9 p.m. PST",4422,4196,4408,-14
NEVP,"12/8/2022 10 p.m. PST",4291,4068,4238,-53
NEVP,"12/8/2022 11 p.m. PST",4126,3862,3925,-201
NEVP,"12/9/2022 12 a.m. PST",3963,3688,3702,-261
NEVP,"12/9/2022 1 a.m. PST",3848,3580,3541,-307
NEVP,"12/9/2022 2 a.m. PST",3777,3586,3187,-590
NEVP,"12/9/2022 3 a.m. PST",3742,3595,2952,-790
NEVP,"12/9/2022 4 a.m. PST",3699,3661,3172,-527
NEVP,"12/9/2022 5 a.m. PST",3843,3762,3045,-798
NEVP,"12/9/2022 6 a.m. PST",4020,3903,3115,-905
NEVP,"12/9/2022 7 a.m. PST",4229,3992,3135,-1094
NEVP,"12/9/2022 8 a.m. PST",4278,4076,3623,-655
NEVP,"12/9/2022 9 a.m. PST",4159,3977,3704,-455
NEVP,"12/9/2022 10 a.m. PST",4119,3781,3712,-407
NEVP,"12/9/2022 11 a.m. PST",4030,3675,3667,-363
NEVP,"12/9/2022 12 p.m. PST",3938,3575,3478,-460
NEVP,"12/9/2022 1 p.m. PST",3924,3542,3416,-508
NEVP,"12/9/2022 2 p.m. PST",3895,3605,3418,-477
NEVP,"12/9/2022 3 p.m. PST",3929,3626,3540,-389
NEVP,"12/9/2022 4 p.m. PST",4038,3755,3520,-518
NEVP,"12/9/2022 5 p.m. PST",4311,4057,3654,-657
NEVP,"12/9/2022 6 p.m. PST",4472,4210,4186,-286
NEVP,"12/9/2022 7 p.m. PST",4458,4196,4231,-227
NEVP,"12/9/2022 8 p.m. PST",4426,4174,4167,-259
NEVP,"12/9/2022 9 p.m. PST",4383,4112,4024,-359
NEVP,"12/9/2022 10 p.m. PST",4289,4063,3625,-664
NEVP,"12/9/2022 11 p.m. PST",4162,3889,3594,-568
NEVP,"12/10/2022 12 a.m. PST",4006,3747,3517,-489
NEVP,"12/10/2022 1 a.m. PST",3910,3740,3479,-431
NEVP,"12/10/2022 2 a.m. PST",3834,3680,3276,-558
NEVP,"12/10/2022 3 a.m. PST",3795,3623,3110,-685
NEVP,"12/10/2022 4 a.m. PST",3780,3623,3124,-656
NEVP,"12/10/2022 5 a.m. PST",3812,3702,3241,-571
NEVP,"12/10/2022 6 a.m. PST",3903,3790,3222,-681
NEVP,"12/10/2022 7 a.m. PST",3994,3753,3317,-677
NEVP,"12/10/2022 8 a.m. PST",4009,3720,3253,-756
NEVP,"12/10/2022 9 a.m. PST",3942,3694,3064,-878
NEVP,"12/10/2022 10 a.m. PST",3963,3637,2999,-964
NEVP,"12/10/2022 11 a.m. PST",3892,3548,3392,-500
NEVP,"12/10/2022 12 p.m. PST",3764,3512,3448,-316
NEVP,"12/10/2022 1 p.m. PST",3743,3445,3285,-458
NEVP,"12/10/2022 2 p.m. PST",3831,3450,3410,-421
NEVP,"12/10/2022 3 p.m. PST",3890,3536,3437,-453
NEVP,"12/10/2022 4 p.m. PST",4009,3616,3435,-574
NEVP,"12/10/2022 5 p.m. PST",4260,3881,3491,-769
NEVP,"12/10/2022 6 p.m. PST",4379,4054,3717,-662
NEVP,"12/10/2022 7 p.m. PST",4357,4046,3441,-916
NEVP,"12/10/2022 8 p.m. PST",4300,3975,3165,-1135
NEVP,"12/10/2022 9 p.m. PST",4230,3940,3201,-1029
NEVP,"12/10/2022 10 p.m. PST",4123,3881,3307,-816
NEVP,"12/10/2022 11 p.m. PST",3995,3732,3271,-724
NEVP,"12/11/2022 12 a.m. PST",3851,3621,3259,-592
NEVP,"12/11/2022 1 a.m. PST",3739,3502,3337,-402
NEVP,"12/11/2022 2 a.m. PST",3670,3455,3368,-302
NEVP,"12/11/2022 3 a.m. PST",3611,3453,3298,-313
NEVP,"12/11/2022 4 a.m. PST",3598,3444,3379,-219
NEVP,"12/11/2022 5 a.m. PST",3605,3462,3466,-139
NEVP,"12/11/2022 6 a.m. PST",3654,3497,3474,-180
NEVP,"12/11/2022 7 a.m. PST",3709,3564,3483,-226
NEVP,"12/11/2022 8 a.m. PST",3682,3558,3046,-636
NEVP,"12/11/2022 9 a.m. PST",3745,3587,2837,-908
NEVP,"12/11/2022 10 a.m. PST",3936,3611,2861,-1075
NEVP,"12/11/2022 11 a.m. PST",4039,3628,2803,-1236
NEVP,"12/11/2022 12 p.m. PST",4017,3632,2747,-1270
NEVP,"12/11/2022 1 p.m. PST",4064,3670,2682,-1382
NEVP,"12/11/2022 2 p.m. PST",4058,3643,2619,-1439
NEVP,"12/11/2022 3 p.m. PST",4011,3766,2868,-1143
NEVP,"12/11/2022 4 p.m. PST",4115,3789,3308,-807
NEVP,"12/11/2022 5 p.m. PST",4307,4049,3789,-518
NEVP,"12/11/2022 6 p.m. PST",4463,4214,4047,-416
NEVP,"12/11/2022 7 p.m. PST",4438,4208,3927,-511
NEVP,"12/11/2022 8 p.m. PST",4386,4145,3937,-449
NEVP,"12/11/2022 9 p.m. PST",4305,4110,3858,-447
NEVP,"12/11/2022 10 p.m. PST",4187,4001,3732,-455
NEVP,"12/11/2022 11 p.m. PST",4027,3933,3599,-428
NEVP,"12/12/2022 12 a.m. PST",3904,3752,3384,-520
NEVP,"12/12/2022 1 a.m. PST",3794,3666,3342,-452
NEVP,"12/12/2022 2 a.m. PST",3759,3657,3370,-389
NEVP,"12/12/2022 3 a.m. PST",3765,3626,3375,-390
NEVP,"12/12/2022 4 a.m. PST",3795,3650,3390,-405
NEVP,"12/12/2022 5 a.m. PST",3907,3702,3452,-455
NEVP,"12/12/2022 6 a.m. PST",4018,3929,3520,-498
NEVP,"12/12/2022 7 a.m. PST",4186,4123,3657,-529
NEVP,"12/12/2022 8 a.m. PST",4193,4174,3928,-265
NEVP,"12/12/2022 9 a.m. PST",4093,4087,4271,178
NEVP,"12/12/2022 10 a.m. PST",4052,3956,4485,433
NEVP,"12/12/2022 11 a.m. PST",4038,3896,4269,231
NEVP,"12/12/2022 12 p.m. PST",3916,3820,4072,156
NEVP,"12/12/2022 1 p.m. PST",3905,3769,4027,122
NEVP,"12/12/2022 2 p.m. PST",3893,3822,3795,-98
NEVP,"12/12/2022 3 p.m. PST",3959,3943,3816,-143
NEVP,"12/12/2022 4 p.m. PST",4052,4038,3787,-265
NEVP,"12/12/2022 5 p.m. PST",4342,4350,4005,-337
NEVP,"12/12/2022 6 p.m. PST",4614,4559,4297,-317
NEVP,"12/12/2022 7 p.m. PST",4611,4535,4276,-335
NEVP,"12/12/2022 8 p.m. PST",4581,4403,4273,-308
NEVP,"12/12/2022 9 p.m. PST",4511,4359,4228,-283
NEVP,"12/12/2022 10 p.m. PST",4363,4235,3966,-397
NEVP,"12/12/2022 11 p.m. PST",4168,4176,3928,-240
NEVP,"12/13/2022 12 a.m. PST",3985,3954,3839,-146
NEVP,"12/13/2022 1 a.m. PST",3872,3888,3594,-278
NEVP,"12/13/2022 2 a.m. PST",3816,3823,3553,-263
NEVP,"12/13/2022 3 a.m. PST",3805,3805,3508,-297
NEVP,"12/13/2022 4 a.m. PST",3820,3901,3400,-420
NEVP,"12/13/2022 5 a.m. PST",3892,3943,3332,-560
NEVP,"12/13/2022 6 a.m. PST",4065,4064,3407,-658
NEVP,"12/13/2022 7 a.m. PST",4261,4288,3801,-460
NEVP,"12/13/2022 8 a.m. PST",4269,4200,3736,-533
NEVP,"12/13/2022 9 a.m. PST",4075,4163,4025,-50
NEVP,"12/13/2022 10 a.m. PST",4080,4066,4158,78
NEVP,"12/13/2022 11 a.m. PST",4022,3969,4050,28
NEVP,"12/13/2022 12 p.m. PST",3969,3862,3975,6
NEVP,"12/13/2022 1 p.m. PST",3938,3845,3817,-121
NEVP,"12/13/2022 2 p.m. PST",3899,3766,3885,-14
NEVP,"12/13/2022 3 p.m. PST",3990,3865,3963,-27
NEVP,"12/13/2022 4 p.m. PST",4151,3966,3858,-293
NEVP,"12/13/2022 5 p.m. PST",4357,4266,3629,-728
NEVP,"12/13/2022 6 p.m. PST",4578,4452,3976,-602
NEVP,"12/13/2022 7 p.m. PST",4598,4450,4068,-530
NEVP,"12/13/2022 8 p.m. PST",4570,4439,4226,-344
NEVP,"12/13/2022 9 p.m. PST",4516,4435,4184,-332
NEVP,"12/13/2022 10 p.m. PST",4391,4360,4079,-312
NEVP,"12/13/2022 11 p.m. PST",4217,4189,3871,-346
NEVP,"12/14/2022 12 a.m. PST",4070,4073,3839,-231
NEVP,"12/14/2022 1 a.m. PST",3974,3833,3507,-467
NEVP,"12/14/2022 2 a.m. PST",3922,3780,3381,-541
NEVP,"12/14/2022 3 a.m. PST",3899,3770,3342,-557
NEVP,"12/14/2022 4 a.m. PST",3940,3793,3318,-622
NEVP,"12/14/2022 5 a.m. PST",4023,3875,3459,-564
NEVP,"12/14/2022 6 a.m. PST",4210,4023,3637,-573
NEVP,"12/14/2022 7 a.m. PST",4414,4220,3800,-614
NEVP,"12/14/2022 8 a.m. PST",4405,4198,3985,-420
NEVP,"12/14/2022 9 a.m. PST",4245,4057,3839,-406
NEVP,"12/14/2022 10 a.m. PST",4153,3950,3777,-376
NEVP,"12/14/2022 11 a.m. PST",4067,3804,3705,-362
NEVP,"12/14/2022 12 p.m. PST",3981,3710,3602,-379
NEVP,"12/14/2022 1 p.m. PST",3935,3636,3560,-375
NEVP,"12/14/2022 2 p.m. PST",3863,3634,3810,-53
NEVP,"12/14/2022 3 p.m. PST",3902,3740,4095,193
NEVP,"12/14/2022 4 p.m. PST",4018,3841,3866,-152
NEVP,"12/14/2022 5 p.m. PST",4348,4186,4175,-173
NEVP,"12/14/2022 6 p.m. PST",4550,4416,4536,-14
NEVP,"12/14/2022 7 p.m. PST",4575,4410,4457,-118
NEVP,"12/14/2022 8 p.m. PST",4567,4438,4515,-52
NEVP,"12/14/2022 9 p.m. PST",4514,4363,4549,35
NEVP,"12/14/2022 10 p.m. PST",4383,4288,4353,-30
NEVP,"12/14/2022 11 p.m. PST",4217,4089,4078,-139
NEVP,"12/15/2022 12 a.m. PST",4069,3935,4018,-51
NEVP,"12/15/2022 1 a.m. PST",3973,3792,3708,-265
NEVP,"12/15/2022 2 a.m. PST",3931,3739,3665,-266
NEVP,"12/15/2022 3 a.m. PST",3897,3734,3707,-190
NEVP,"12/15/2022 4 a.m. PST",3916,3733,3714,-202
NEVP,"12/15/2022 5 a.m. PST",4017,3850,3719,-298
NEVP,"12/15/2022 6 a.m. PST",4219,4020,3783,-436
NEVP,"12/15/2022 7 a.m. PST",4421,4185,3951,-470
NEVP,"12/15/2022 8 a.m. PST",4411,4172,4199,-212
NEVP,"12/15/2022 9 a.m. PST",4285,4021,4196,-89
NEVP,"12/15/2022 10 a.m. PST",4217,3990,3902,-315
NEVP,"12/15/2022 11 a.m. PST",3899,3853,3513,-386
NEVP,"12/15/2022 12 p.m. PST",4005,3758,3509,-496
NEVP,"12/15/2022 1 p.m. PST",3946,3715,3585,-361
NEVP,"12/15/2022 2 p.m. PST",3913,3650,3816,-97
NEVP,"12/15/2022 3 p.m. PST",3968,3764,4013,45
NEVP,"12/15/2022 4 p.m. PST",4107,3904,3813,-294
NEVP,"12/15/2022 5 p.m. PST",4382,4118,4151,-231
NEVP,"12/15/2022 6 p.m. PST",4596,4357,4492,-104
NEVP,"12/15/2022 7 p.m. PST",4606,4355,4357,-249
NEVP,"12/15/2022 8 p.m. PST",4584,4431,4316,-268
NEVP,"12/15/2022 9 p.m. PST",4545,4340,4262,-283
NEVP,"12/15/2022 10 p.m. PST",4434,4250,4069,-365
NEVP,"12/15/2022 11 p.m. PST",4274,4142,4081,-193
NEVP,"12/16/2022 12 a.m. PST",4118,3982,4042,-76
NEVP,"12/16/2022 1 a.m. PST",4019,3855,3683,-336
NEVP,"12/16/2022 2 a.m. PST",3974,3818,3591,-383
NEVP,"12/16/2022 3 a.m. PST",3960,3810,3518,-442
NEVP,"12/16/2022 4 a.m. PST",3997,3848,3443,-554
NEVP,"12/16/2022 5 a.m. PST",4085,3880,3564,-521
NEVP,"12/16/2022 6 a.m. PST",4259,4019,3703,-556
NEVP,"12/16/2022 7 a.m. PST",4455,4203,3734,-721
NEVP,"12/16/2022 8 a.m. PST",4461,4183,4016,-445
NEVP,"12/16/2022 9 a.m. PST",4314,4090,4239,-75
NEVP,"12/16/2022 10 a.m. PST",4239,3998,3870,-369
NEVP,"12/16/2022 11 a.m. PST",4155,3853,3801,-354
NEVP,"12/16/2022 12 p.m. PST",4080,3733,3730,-350
NEVP,"12/16/2022 1 p.m. PST",3997,3674,3834,-163
NEVP,"12/16/2022 2 p.m. PST",3980,3604,3778,-202
NEVP,"12/16/2022 3 p.m. PST",3993,3669,4040,47
NEVP,"12/16/2022 4 p.m. PST",4101,3826,3917,-184
NEVP,"12/16/2022 5 p.m. PST",4403,4180,4130,-273
NEVP,"12/16/2022 6 p.m. PST",4630,4306,4294,-336
NEVP,"12/16/2022 7 p.m. PST",4620,4343,4322,-298
NEVP,"12/16/2022 8 p.m. PST",4615,4390,4310,-305
NEVP,"12/16/2022 9 p.m. PST",4580,4381,4348,-232
NEVP,"12/16/2022 10 p.m. PST",4512,4342,4336,-176
NEVP,"12/16/2022 11 p.m. PST",4381,4166,4269,-112
NEVP,"12/17/2022 12 a.m. PST",4250,3990,4115,-135
NEVP,"12/17/2022 1 a.m. PST",4155,3783,3731,-424
NEVP,"12/17/2022 2 a.m. PST",4088,3722,3542,-546
NEVP,"12/17/2022 3 a.m. PST",4070,3699,3530,-540
NEVP,"12/17/2022 4 a.m. PST",4080,3728,3379,-701
NEVP,"12/17/2022 5 a.m. PST",4128,3731,3221,-907
NEVP,"12/17/2022 6 a.m. PST",4220,3834,3135,-1085
NEVP,"12/17/2022 7 a.m. PST",4306,3926,3108,-1198
NEVP,"12/17/2022 8 a.m. PST",4283,4048,3809,-474
NEVP,"12/17/2022 9 a.m. PST",4205,3963,3805,-400
NEVP,"12/17/2022 10 a.m. PST",4140,3871,3639,-501
NEVP,"12/17/2022 11 a.m. PST",4053,3623,3603,-450
NEVP,"12/17/2022 12 p.m. PST",3964,3648,3390,-574
NEVP,"12/17/2022 1 p.m. PST",3919,3558,3312,-607
NEVP,"12/17/2022 2 p.m. PST",3878,3600,3566,-312
NEVP,"12/17/2022 3 p.m. PST",3892,3702,3821,-71
NEVP,"12/17/2022 4 p.m. PST",4027,3709,3830,-197
NEVP,"12/17/2022 5 p.m. PST",4332,4130,3849,-483
NEVP,"12/17/2022 6 p.m. PST",4547,4254,4309,-238
NEVP,"12/17/2022 7 p.m. PST",4545,4288,4332,-213
NEVP,"12/17/2022 8 p.m. PST",4549,4271,4075,-474
NEVP,"12/17/2022 9 p.m. PST",4515,4265,3897,-618
NEVP,"12/17/2022 10 p.m. PST",4446,4228,3848,-598
NEVP,"12/17/2022 11 p.m. PST",4361,4072,3719,-642
NEVP,"12/18/2022 12 a.m. PST",4241,3899,3540,-701
NEVP,"12/18/2022 1 a.m. PST",4145,3759,3429,-716
NEVP,"12/18/2022 2 a.m. PST",4075,3703,3287,-788
NEVP,"12/18/2022 3 a.m. PST",4037,3636,3133,-904
NEVP,"12/18/2022 4 a.m. PST",4037,3659,3145,-892
NEVP,"12/18/2022 5 a.m. PST",4069,3662,3177,-892
NEVP,"12/18/2022 6 a.m. PST",4128,3740,3109,-1019
NEVP,"12/18/2022 7 a.m. PST",4216,3860,3137,-1079
NEVP,"12/18/2022 8 a.m. PST",4251,3814,3491,-760
NEVP,"12/18/2022 9 a.m. PST",4207,3742,3520,-687
NEVP,"12/18/2022 10 a.m. PST",4102,3703,3557,-545
NEVP,"12/18/2022 11 a.m. PST",4008,3641,3659,-349
NEVP,"12/18/2022 12 p.m. PST",3941,3552,3430,-511
NEVP,"12/18/2022 1 p.m. PST",3877,3476,3459,-418
NEVP,"12/18/2022 2 p.m. PST",3836,3475,3444,-392
NEVP,"12/18/2022 3 p.m. PST",3856,3558,3735,-121
NEVP,"12/18/2022 4 p.m. PST",3974,3691,3711,-263
NEVP,"12/18/2022 5 p.m. PST",4275,3976,3993,-282
NEVP,"12/18/2022 6 p.m. PST",4545,4221,4218,-327
NEVP,"12/18/2022 7 p.m. PST",4557,4277,4174,-383
NEVP,"12/18/2022 8 p.m. PST",4566,4277,4079,-487
NEVP,"12/18/2022 9 p.m. PST",4544,4239,4043,-501
NEVP,"12/18/2022 10 p.m. PST",4467,4137,3998,-469
NEVP,"12/18/2022 11 p.m. PST",4330,3934,3959,-371
NEVP,"12/19/2022 12 a.m. PST",4212,3782,3620,-592
NEVP,"12/19/2022 1 a.m. PST",4115,3680,3428,-687
NEVP,"12/19/2022 2 a.m. PST",4066,3666,3257,-809
NEVP,"12/19/2022 3 a.m. PST",4053,3658,3372,-681
NEVP,"12/19/2022 4 a.m. PST",4101,3703,3445,-656
NEVP,"12/19/2022 5 a.m. PST",4183,3755,3590,-593
NEVP,"12/19/2022 6 a.m. PST",4372,3909,3816,-556
NEVP,"12/19/2022 7 a.m. PST",4568,4139,4087,-481
NEVP,"12/19/2022 8 a.m. PST",4572,4166,4202,-370
NEVP,"12/19/2022 9 a.m. PST",4470,4047,4532,62
NEVP,"12/19/2022 10 a.m. PST",4345,3921,4148,-197
NEVP,"12/19/2022 11 a.m. PST",4233,3804,3745,-488
NEVP,"12/19/2022 12 p.m. PST",4137,3712,3388,-749
NEVP,"12/19/2022 1 p.m. PST",4088,3652,3463,-625
NEVP,"12/19/2022 2 p.m. PST",4049,3740,3649,-400
NEVP,"12/19/2022 3 p.m. PST",4074,3786,3866,-208
NEVP,"12/19/2022 4 p.m. PST",4205,3934,3913,-292
NEVP,"12/19/2022 5 p.m. PST",4479,4200,4167,-312
NEVP,"12/19/2022 6 p.m. PST",4704,4414,4300,-404
NEVP,"12/19/2022 7 p.m. PST",4705,4445,4223,-482
NEVP,"12/19/2022 8 p.m. PST",4695,4380,3998,-697
NEVP,"12/19/2022 9 p.m. PST",4623,4322,3847,-776
NEVP,"12/19/2022 10 p.m. PST",4500,4154,3810,-690
NEVP,"12/19/2022 11 p.m. PST",4312,3900,3582,-730
NEVP,"12/20/2022 12 a.m. PST",4135,3765,2978,-1157
NEVP,"12/20/2022 1 a.m. PST",4031,3655,3272,-759
NEVP,"12/20/2022 2 a.m. PST",3942,3619,3320,-622
NEVP,"12/20/2022 3 a.m. PST",3890,3576,3367,-523
NEVP,"12/20/2022 4 a.m. PST",3892,3601,3084,-808
NEVP,"12/20/2022 5 a.m. PST",3977,3717,2903,-1074
NEVP,"12/20/2022 6 a.m. PST",4127,3838,3422,-705
NEVP,"12/20/2022 7 a.m. PST",4299,4041,3736,-563
NEVP,"12/20/2022 8 a.m. PST",4347,4022,3737,-610
NEVP,"12/20/2022 9 a.m. PST",4376,3896,3749,-627
NEVP,"12/20/2022 10 a.m. PST",4284,3824,3754,-530
NEVP,"12/20/2022 11 a.m. PST",4113,3731,3880,-233
NEVP,"12/20/2022 12 p.m. PST",3916,3682,3877,-39
NEVP,"12/20/2022 1 p.m. PST",3952,3626,3846,-106
NEVP,"12/20/2022 2 p.m. PST",3915,3599,3925,10
NEVP,"12/20/2022 3 p.m. PST",3922,3683,3796,-126
NEVP,"12/20/2022 4 p.m. PST",4038,3775,3424,-614
NEVP,"12/20/2022 5 p.m. PST",4285,4035,3318,-967
NEVP,"12/20/2022 6 p.m. PST",4519,4304,3400,-1119
NEVP,"12/20/2022 7 p.m. PST",4536,4315,3238,-1298
NEVP,"12/20/2022 8 p.m. PST",4524,4262,3151,-1373
NEVP,"12/20/2022 9 p.m. PST",4484,4205,3037,-1447
NEVP,"12/20/2022 10 p.m. PST",4363,4075,2855,-1508
NEVP,"12/20/2022 11 p.m. PST",4210,3835,2713,-1497
NEVP,"12/21/2022 12 a.m. PST",4063,3682,2701,-1362
NEVP,"12/21/2022 1 a.m. PST",3949,3627,2953,-996
NEVP,"12/21/2022 2 a.m. PST",3888,3607,3044,-844
NEVP,"12/21/2022 3 a.m. PST",3868,3557,2985,-883
NEVP,"12/21/2022 4 a.m. PST",3869,3588,3056,-813
NEVP,"12/21/2022 5 a.m. PST",3955,3699,3254,-701
NEVP,"12/21/2022 6 a.m. PST",4133,3878,3313,-820
NEVP,"12/21/2022 7 a.m. PST",4305,4034,3724,-581
NEVP,"12/21/2022 8 a.m. PST",4301,4053,3998,-303
NEVP,"12/21/2022 9 a.m. PST",4212,3888,4049,-163
NEVP,"12/21/2022 10 a.m. PST",4125,3744,3899,-226
NEVP,"12/21/2022 11 a.m. PST",4022,3683,4034,12
NEVP,"12/21/2022 12 p.m. PST",3921,3610,4032,111
NEVP,"12/21/2022 1 p.m. PST",3870,3545,3942,72
NEVP,"12/21/2022 2 p.m. PST",3847,3587,4063,216
NEVP,"12/21/2022 3 p.m. PST",3854,3623,3971,117
NEVP,"12/21/2022 4 p.m. PST",3966,3748,3416,-550
NEVP,"12/21/2022 5 p.m. PST",4233,4026,3356,-877
NEVP,"12/21/2022 6 p.m. PST",4443,4238,3534,-909
NEVP,"12/21/2022 7 p.m. PST",4440,4237,3560,-880
NEVP,"12/21/2022 8 p.m. PST",4418,4162,3601,-817
NEVP,"12/21/2022 9 p.m. PST",4394,4152,3240,-1154
NEVP,"12/21/2022 10 p.m. PST",4292,4025,2873,-1419
NEVP,"12/21/2022 11 p.m. PST",4149,3805,2769,-1380
NEVP,"12/22/2022 12 a.m. PST",3978,3663,2488,-1490
NEVP,"12/22/2022 1 a.m. PST",3878,3698,2496,-1382
NEVP,"12/22/2022 2 a.m. PST",3802,3646,2560,-1242
NEVP,"12/22/2022 3 a.m. PST",3770,3634,2503,-1267
NEVP,"12/22/2022 4 a.m. PST",3801,3642,2491,-1310
NEVP,"12/22/2022 5 a.m. PST",3869,3739,2493,-1376
NEVP,"12/22/2022 6 a.m. PST",4025,3874,2950,-1075
NEVP,"12/22/2022 7 a.m. PST",4182,4046,3286,-896
NEVP,"12/22/2022 8 a.m. PST",4208,4097,3696,-512
NEVP,"12/22/2022 9 a.m. PST",4159,4077,3930,-229
NEVP,"12/22/2022 10 a.m. PST",4074,3961,4194,120
NEVP,"12/22/2022 11 a.m. PST",3971,3871,4041,70
NEVP,"12/22/2022 12 p.m. PST",3915,3824,3977,62
NEVP,"12/22/2022 1 p.m. PST",3959,3818,3949,-10
NEVP,"12/22/2022 2 p.m. PST",3946,3798,3746,-200
NEVP,"12/22/2022 3 p.m. PST",3935,3800,3454,-481
NEVP,"12/22/2022 4 p.m. PST",4068,3889,3408,-660
NEVP,"12/22/2022 5 p.m. PST",4287,4081,3570,-717
NEVP,"12/22/2022 6 p.m. PST",4430,4251,3608,-822
NEVP,"12/22/2022 7 p.m. PST",4409,4257,3621,-788
NEVP,"12/22/2022 8 p.m. PST",4367,4190,3856,-511
NEVP,"12/22/2022 9 p.m. PST",4331,4100,3842,-489
NEVP,"12/22/2022 10 p.m. PST",4224,4040,3791,-433
NEVP,"12/22/2022 11 p.m. PST",4416,3859,3791,-625
NEVP,"12/23/2022 12 a.m. PST",3913,3703,3274,-639
NEVP,"12/23/2022 1 a.m. PST",3787,3589,3215,-572
NEVP,"12/23/2022 2 a.m. PST",3707,3536,3143,-564
NEVP,"12/23/2022 3 a.m. PST",3672,3502,3144,-528
NEVP,"12/23/2022 4 a.m. PST",3668,3529,3229,-439
NEVP,"12/23/2022 5 a.m. PST",3712,3576,3553,-159
NEVP,"12/23/2022 6 a.m. PST",3840,3690,3541,-299
NEVP,"12/23/2022 7 a.m. PST",3977,3759,3531,-446
NEVP,"12/23/2022 8 a.m. PST",4023,3799,3567,-456
NEVP,"12/23/2022 9 a.m. PST",3926,3785,3106,-820
NEVP,"12/23/2022 10 a.m. PST",3773,3721,3522,-251
NEVP,"12/23/2022 11 a.m. PST",3825,3680,3515,-310
NEVP,"12/23/2022 12 p.m. PST",3788,3597,3349,-439
NEVP,"12/23/2022 1 p.m. PST",3647,3544,3158,-489
NEVP,"12/23/2022 2 p.m. PST",3641,3544,3244,-397
NEVP,"12/23/2022 3 p.m. PST",3691,3619,3523,-168
NEVP,"12/23/2022 4 p.m. PST",3774,3710,3395,-379
NEVP,"12/23/2022 5 p.m. PST",3989,3972,3558,-431
NEVP,"12/23/2022 6 p.m. PST",4183,4168,3535,-648
NEVP,"12/23/2022 7 p.m. PST",4192,4127,3224,-968
NEVP,"12/23/2022 8 p.m. PST",4149,4084,3146,-1003
NEVP,"12/23/2022 9 p.m. PST",4134,4037,3098,-1036
NEVP,"12/23/2022 10 p.m. PST",4055,3953,3044,-1011
NEVP,"12/23/2022 11 p.m. PST",3955,3835,2742,-1213
NEVP,"12/24/2022 12 a.m. PST",3820,3685,2572,-1248
NEVP,"12/24/2022 1 a.m. PST",3718,3612,2818,-900
NEVP,"12/24/2022 2 a.m. PST",3647,3537,2882,-765
NEVP,"12/24/2022 3 a.m. PST",3607,3453,2897,-710
NEVP,"12/24/2022 4 a.m. PST",3604,3466,2907,-697
NEVP,"12/24/2022 5 a.m. PST",3644,3465,3215,-429
NEVP,"12/24/2022 6 a.m. PST",3726,3523,3278,-448
NEVP,"12/24/2022 7 a.m. PST",3806,3581,3567,-239
NEVP,"12/24/2022 8 a.m. PST",3800,3565,3333,-467
NEVP,"12/24/2022 9 a.m. PST",3738,3550,3261,-477
NEVP,"12/24/2022 10 a.m. PST",3746,3494,3345,-401
NEVP,"12/24/2022 11 a.m. PST",3668,3496,3180,-488
NEVP,"12/24/2022 12 p.m. PST",3586,3425,3079,-507
NEVP,"12/24/2022 1 p.m. PST",3546,3371,3011,-535
NEVP,"12/24/2022 2 p.m. PST",3546,3367,3084,-462
NEVP,"12/24/2022 3 p.m. PST",3583,3481,3374,-209
NEVP,"12/24/2022 4 p.m. PST",3700,3539,3056,-644
NEVP,"12/24/2022 5 p.m. PST",3910,3822,2981,-929
NEVP,"12/24/2022 6 p.m. PST",4083,4009,3215,-868
NEVP,"12/24/2022 7 p.m. PST",4051,3985,3075,-976
NEVP,"12/24/2022 8 p.m. PST",3988,3921,2808,-1180
NEVP,"12/24/2022 9 p.m. PST",3947,3843,2601,-1346
NEVP,"12/24/2022 10 p.m. PST",3889,3782,2483,-1406
NEVP,"12/24/2022 11 p.m. PST",3803,3713,2524,-1279
NEVP,"12/25/2022 12 a.m. PST",3702,3590,2342,-1360
NEVP,"12/25/2022 1 a.m. PST",3622,3484,2534,-1088
NEVP,"12/25/2022 2 a.m. PST",3552,3394,2625,-927
NEVP,"12/25/2022 3 a.m. PST",3519,3360,3001,-518
NEVP,"12/25/2022 4 a.m. PST",3506,3369,3050,-456
NEVP,"12/25/2022 5 a.m. PST",3511,3382,3280,-231
NEVP,"12/25/2022 6 a.m. PST",3582,3362,3503,-79
NEVP,"12/25/2022 7 a.m. PST",3654,3440,3569,-85
NEVP,"12/25/2022 8 a.m. PST",3627,3428,2739,-888
NEVP,"12/25/2022 9 a.m. PST",3561,3420,2833,-728
NEVP,"12/25/2022 10 a.m. PST",3547,3392,3159,-388
NEVP,"12/25/2022 11 a.m. PST",3474,3406,3008,-466
NEVP,"12/25/2022 12 p.m. PST",3418,3351,2989,-429
NEVP,"12/25/2022 1 p.m. PST",3396,3323,2982,-414
NEVP,"12/25/2022 2 p.m. PST",3401,3350,3245,-156
NEVP,"12/25/2022 3 p.m. PST",3422,3452,3550,128
NEVP,"12/25/2022 4 p.m. PST",3519,3553,3272,-247
NEVP,"12/25/2022 5 p.m. PST",3720,3806,3482,-238
NEVP,"12/25/2022 6 p.m. PST",3905,4014,3727,-178
NEVP,"12/25/2022 7 p.m. PST",3875,3990,3709,-166
NEVP,"12/25/2022 8 p.m. PST",3847,3956,3665,-182
NEVP,"12/25/2022 9 p.m. PST",3827,3877,3575,-252
NEVP,"12/25/2022 10 p.m. PST",3776,3761,3370,-406
NEVP,"12/25/2022 11 p.m. PST",3687,3659,3291,-396
NEVP,"12/26/2022 12 a.m. PST",3595,3489,3515,-80
NEVP,"12/26/2022 1 a.m. PST",3507,3368,3523,16
NEVP,"12/26/2022 2 a.m. PST",3427,3343,3445,18
NEVP,"12/26/2022 3 a.m. PST",3408,3319,3443,35
NEVP,"12/26/2022 4 a.m. PST",3412,3371,3338,-74
NEVP,"12/26/2022 5 a.m. PST",3456,3448,3281,-175
NEVP,"12/26/2022 6 a.m. PST",3548,3597,3295,-253
NEVP,"12/26/2022 7 a.m. PST",3653,3804,3293,-360
NEVP,"12/26/2022 8 a.m. PST",3637,3838,2370,-1267
NEVP,"12/26/2022 9 a.m. PST",3624,3723,2611,-1013
NEVP,"12/26/2022 10 a.m. PST",3649,3639,2692,-957
NEVP,"12/26/2022 11 a.m. PST",3632,3589,2685,-947
NEVP,"12/26/2022 12 p.m. PST",3611,3520,2606,-1005
NEVP,"12/26/2022 1 p.m. PST",3574,3504,3053,-521
NEVP,"12/26/2022 2 p.m. PST",3603,3553,3176,-427
NEVP,"12/26/2022 3 p.m. PST",3669,3650,3072,-597
NEVP,"12/26/2022 4 p.m. PST",3738,3700,3144,-594
NEVP,"12/26/2022 5 p.m. PST",3956,4011,3620,-336
NEVP,"12/26/2022 6 p.m. PST",4141,4204,3658,-483
NEVP,"12/26/2022 7 p.m. PST",4143,4157,3649,-494
NEVP,"12/26/2022 8 p.m. PST",4088,4096,3531,-557
NEVP,"12/26/2022 9 p.m. PST",4034,4017,3438,-596
NEVP,"12/26/2022 10 p.m. PST",3921,3879,3433,-488
NEVP,"12/26/2022 11 p.m. PST",3789,3718,3364,-425
NEVP,"12/27/2022 12 a.m. PST",3665,3575,3376,-289
NEVP,"12/27/2022 1 a.m. PST",3553,3429,3441,-112
NEVP,"12/27/2022 2 a.m. PST",3468,3413,3389,-79
NEVP,"12/27/2022 3 a.m. PST",3433,3361,3269,-164
NEVP,"12/27/2022 4 a.m. PST",3431,3402,3296,-135
NEVP,"12/27/2022 5 a.m. PST",3510,3523,3254,-256
NEVP,"12/27/2022 6 a.m. PST",3609,3708,3092,-517
NEVP,"12/27/2022 7 a.m. PST",3777,3943,3219,-558
NEVP,"12/27/2022 8 a.m. PST",3875,3905,2468,-1407
NEVP,"12/27/2022 9 a.m. PST",3987,3830,2839,-1148
NEVP,"12/27/2022 10 a.m. PST",4050,3758,3095,-955
NEVP,"12/27/2022 11 a.m. PST",4031,3674,3322,-709
NEVP,"12/27/2022 12 p.m. PST",4077,3637,3224,-853
NEVP,"12/27/2022 1 p.m. PST",4115,3608,3249,-866
NEVP,"12/27/2022 2 p.m. PST",4106,3552,3271,-835
NEVP,"12/27/2022 3 p.m. PST",4044,3685,3319,-725
NEVP,"12/27/2022 4 p.m. PST",4050,3716,3440,-610
NEVP,"12/27/2022 5 p.m. PST",4239,3871,3626,-613
NEVP,"12/27/2022 6 p.m. PST",4362,4070,3680,-682
NEVP,"12/27/2022 7 p.m. PST",4315,4111,3692,-623
NEVP,"12/27/2022 8 p.m. PST",4242,4067,3726,-516
NEVP,"12/27/2022 9 p.m. PST",4142,3997,3662,-480
NEVP,"12/27/2022 10 p.m. PST",4007,3891,3296,-711
NEVP,"12/27/2022 11 p.m. PST",3859,3751,2874,-985
NEVP,"12/28/2022 12 a.m. PST",3703,3561,2476,-1227
NEVP,"12/28/2022 1 a.m. PST",3560,3407,2427,-1133
NEVP,"12/28/2022 2 a.m. PST",3500,3343,2816,-684
NEVP,"12/28/2022 3 a.m. PST",3448,3264,2837,-611
NEVP,"12/28/2022 4 a.m. PST",3442,3280,2997,-445
NEVP,"12/28/2022 5 a.m. PST",3497,3350,3129,-368
NEVP,"12/28/2022 6 a.m. PST",3626,3493,3210,-416
NEVP,"12/28/2022 7 a.m. PST",3783,3664,3211,-572
NEVP,"12/28/2022 8 a.m. PST",3826,3667,2899,-927
NEVP,"12/28/2022 9 a.m. PST",3792,3634,3217,-575
NEVP,"12/28/2022 10 a.m. PST",3787,3673,3158,-629
NEVP,"12/28/2022 11 a.m. PST",3777,3616,3018,-759
NEVP,"12/28/2022 12 p.m. PST",3750,3586,2949,-801
NEVP,"12/28/2022 1 p.m. PST",3754,3552,2837,-917
NEVP,"12/28/2022 2 p.m. PST",3752,3562,3102,-650
NEVP,"12/28/2022 3 p.m. PST",3737,3504,3391,-346
NEVP,"12/28/2022 4 p.m. PST",3827,3650,3150,-677
NEVP,"12/28/2022 5 p.m. PST",4074,3848,3324,-750
NEVP,"12/28/2022 6 p.m. PST",4325,4062,3645,-680
NEVP,"12/28/2022 7 p.m. PST",4330,4067,3749,-581
NEVP,"12/28/2022 8 p.m. PST",4285,4014,3607,-678
NEVP,"12/28/2022 9 p.m. PST",4226,3989,3426,-800
NEVP,"12/28/2022 10 p.m. PST",4105,3923,3385,-720
NEVP,"12/28/2022 11 p.m. PST",3971,3795,3142,-829
NEVP,"12/29/2022 12 a.m. PST",3824,3656,3053,-771
NEVP,"12/29/2022 1 a.m. PST",3728,3552,3083,-645
NEVP,"12/29/2022 2 a.m. PST",3671,3514,3030,-641
NEVP,"12/29/2022 3 a.m. PST",3652,3508,3019,-633
NEVP,"12/29/2022 4 a.m. PST",3642,3548,3036,-606
NEVP,"12/29/2022 5 a.m. PST",3690,3636,3043,-647
NEVP,"12/29/2022 6 a.m. PST",3816,3774,3078,-738
NEVP,"12/29/2022 7 a.m. PST",3958,3866,3173,-785
NEVP,"12/29/2022 8 a.m. PST",4029,4016,3235,-794
NEVP,"12/29/2022 9 a.m. PST",4089,3961,3118,-971
NEVP,"12/29/2022 10 a.m. PST",4171,3901,3075,-1096
NEVP,"12/29/2022 11 a.m. PST",4102,3827,3272,-830
NEVP,"12/29/2022 12 p.m. PST",3995,3788,3807,-188
NEVP,"12/29/2022 1 p.m. PST",3936,3773,3718,-218
NEVP,"12/29/2022 2 p.m. PST",3924,3759,3570,-354
NEVP,"12/29/2022 3 p.m. PST",3881,3777,3366,-515
NEVP,"12/29/2022 4 p.m. PST",3989,3857,3372,-617
NEVP,"12/29/2022 5 p.m. PST",4225,4073,3585,-640
NEVP,"12/29/2022 6 p.m. PST",4422,4257,3831,-591
NEVP,"12/29/2022 7 p.m. PST",4394,4207,3797,-597
NEVP,"12/29/2022 8 p.m. PST",4355,4106,3785,-570
NEVP,"12/29/2022 9 p.m. PST",4291,4048,3503,-788
NEVP,"12/29/2022 10 p.m. PST",4189,3942,3422,-767
NEVP,"12/29/2022 11 p.m. PST",4050,3854,3271,-779
NEVP,"12/30/2022 12 a.m. PST",3891,3656,3299,-592
NEVP,"12/30/2022 1 a.m. PST",3777,3552,3201,-576
NEVP,"12/30/2022 2 a.m. PST",3707,3460,3018,-689
NEVP,"12/30/2022 3 a.m. PST",3652,3415,2933,-719
NEVP,"12/30/2022 4 a.m. PST",3654,3413,2890,-764
NEVP,"12/30/2022 5 a.m. PST",3697,3457,3022,-675
NEVP,"12/30/2022 6 a.m. PST",3795,3572,3002,-793
NEVP,"12/30/2022 7 a.m. PST",3923,3707,2771,-1152
NEVP,"12/30/2022 8 a.m. PST",3986,3776,2998,-988
NEVP,"12/30/2022 9 a.m. PST",4048,3748,2705,-1343
NEVP,"12/30/2022 10 a.m. PST",4152,3772,2848,-1304
NEVP,"12/30/2022 11 a.m. PST",4148,3812,2979,-1169
NEVP,"12/30/2022 12 p.m. PST",4078,3775,2775,-1303
NEVP,"12/30/2022 1 p.m. PST",4066,3773,2778,-1288
NEVP,"12/30/2022 2 p.m. PST",4054,3748,2529,-1525
NEVP,"12/30/2022 3 p.m. PST",4044,3725,2631,-1413
NEVP,"12/30/2022 4 p.m. PST",4137,3748,2967,-1170
NEVP,"12/30/2022 5 p.m. PST",4298,4010,3729,-569
NEVP,"12/30/2022 6 p.m. PST",4407,4141,3929,-478
NEVP,"12/30/2022 7 p.m. PST",4347,4069,3905,-442
NEVP,"12/30/2022 8 p.m. PST",4280,3967,3699,-581
NEVP,"12/30/2022 9 p.m. PST",4191,3895,3629,-562
NEVP,"12/30/2022 10 p.m. PST",4064,3799,3466,-598
NEVP,"12/30/2022 11 p.m. PST",3927,3746,3365,-562
NEVP,"12/31/2022 12 a.m. PST",3778,3635,3097,-681
NEVP,"12/31/2022 1 a.m. PST",3645,3523,3149,-496
NEVP,"12/31/2022 2 a.m. PST",3560,3417,3034,-526
NEVP,"12/31/2022 3 a.m. PST",3489,3364,2948,-541
NEVP,"12/31/2022 4 a.m. PST",3475,3339,2706,-769
NEVP,"12/31/2022 5 a.m. PST",3493,3338,2717,-776
NEVP,"12/31/2022 6 a.m. PST",3514,3397,2631,-883
NEVP,"12/31/2022 7 a.m. PST",3590,3469,2586,-1004
NEVP,"12/31/2022 8 a.m. PST",3623,3423,2790,-833
NEVP,"12/31/2022 9 a.m. PST",3709,3452,2797,-912
NEVP,"12/31/2022 10 a.m. PST",3748,3541,2918,-830
NEVP,"12/31/2022 11 a.m. PST",3815,3535,2858,-957
NEVP,"12/31/2022 12 p.m. PST",3859,3562,2708,-1151
NEVP,"12/31/2022 1 p.m. PST",3870,3518,2794,-1076
NEVP,"12/31/2022 2 p.m. PST",3943,3520,2944,-999
NEVP,"12/31/2022 3 p.m. PST",3944,3575,3053,-891
NEVP,"12/31/2022 4 p.m. PST",3970,3603,3227,-743
NEVP,"12/31/2022 5 p.m. PST",4097,3857,3396,-701
NEVP,"12/31/2022 6 p.m. PST",4193,3998,3438,-755
NEVP,"12/31/2022 7 p.m. PST",4121,3976,3441,-680
NEVP,"12/31/2022 8 p.m. PST",4043,3885,3431,-612
NEVP,"12/31/2022 9 p.m. PST",3955,3901,3327,-628
NEVP,"12/31/2022 10 p.m. PST",3846,3753,3296,-550
NEVP,"12/31/2022 11 p.m. PST",3762,3732,3309,-453
NEVP,"1/1/2023 12 a.m. PST",3633,3605,3283,-350
