"BA Code","Timestamp (Hour Ending)","Demand (MWh)","Demand Forecast (MWh)","Net Generation (MWh)","Total Interchange (MWh)"
NEVP,"1/1/2023 12 a.m. PST",3633,3605,3283,-350
NEVP,"1/1/2023 1 a.m. PST",3550,3487,3289,-261
NEVP,"1/1/2023 2 a.m. PST",3483,3463,3275,-208
NEVP,"1/1/2023 3 a.m. PST",3430,3420,3105,-325
NEVP,"1/1/2023 4 a.m. PST",3395,3396,3172,-223
NEVP,"1/1/2023 5 a.m. PST",3363,3357,3193,-170
NEVP,"1/1/2023 6 a.m. PST",3392,3388,3225,-167
NEVP,"1/1/2023 7 a.m. PST",3448,3435,3055,-393
NEVP,"1/1/2023 8 a.m. PST",3484,3439,2797,-687
NEVP,"1/1/2023 9 a.m. PST",3509,3480,2807,-702
NEVP,"1/1/2023 10 a.m. PST",3382,3552,3029,-353
NEVP,"1/1/2023 11 a.m. PST",3414,3597,3447,33
NEVP,"1/1/2023 12 p.m. PST",3405,3560,3358,-47
NEVP,"1/1/2023 1 p.m. PST",3505,3545,3305,-200
NEVP,"1/1/2023 2 p.m. PST",3587,3518,3022,-565
NEVP,"1/1/2023 3 p.m. PST",3682,3563,2852,-830
NEVP,"1/1/2023 4 p.m. PST",3766,3633,2723,-1043
NEVP,"1/1/2023 5 p.m. PST",3956,3957,3275,-681
NEVP,"1/1/2023 6 p.m. PST",4170,4167,3573,-597
NEVP,"1/1/2023 7 p.m. PST",4160,4118,3543,-617
NEVP,"1/1/2023 8 p.m. PST",4135,4045,3595,-540
NEVP,"1/1/2023 9 p.m. PST",4093,4024,3580,-513
NEVP,"1/1/2023 10 p.m. PST",3993,3919,3517,-476
NEVP,"1/1/2023 11 p.m. PST",3875,3860,3471,-404
NEVP,"1/2/2023 12 a.m. PST",3742,3719,3449,-293
NEVP,"1/2/2023 1 a.m. PST",3655,3672,3484,-171
NEVP,"1/2/2023 2 a.m. PST",3592,3612,3420,-172
NEVP,"1/2/2023 3 a.m. PST",3565,3540,3387,-178
NEVP,"1/2/2023 4 a.m. PST",3570,3615,3235,-335
NEVP,"1/2/2023 5 a.m. PST",3617,3628,3338,-279
NEVP,"1/2/2023 6 a.m. PST",3706,3857,3428,-278
NEVP,"1/2/2023 7 a.m. PST",3834,4038,3450,-384
NEVP,"1/2/2023 8 a.m. PST",3845,4068,3511,-334
NEVP,"1/2/2023 9 a.m. PST",3788,4003,3934,146
NEVP,"1/2/2023 10 a.m. PST",3810,3880,3979,169
NEVP,"1/2/2023 11 a.m. PST",3749,3839,3939,190
NEVP,"1/2/2023 12 p.m. PST",3696,3693,3863,167
NEVP,"1/2/2023 1 p.m. PST",3698,3650,3868,170
NEVP,"1/2/2023 2 p.m. PST",3722,3722,3946,224
NEVP,"1/2/2023 3 p.m. PST",3812,3761,3882,70
NEVP,"1/2/2023 4 p.m. PST",3975,3821,3554,-421
NEVP,"1/2/2023 5 p.m. PST",4209,4212,3579,-630
NEVP,"1/2/2023 6 p.m. PST",4426,4496,3920,-506
NEVP,"1/2/2023 7 p.m. PST",4421,4414,3904,-517
NEVP,"1/2/2023 8 p.m. PST",4387,4377,3754,-633
NEVP,"1/2/2023 9 p.m. PST",4312,4268,3714,-598
NEVP,"1/2/2023 10 p.m. PST",4178,4111,3663,-515
NEVP,"1/2/2023 11 p.m. PST",4027,4028,3477,-550
NEVP,"1/3/2023 12 a.m. PST",3874,3857,3207,-667
NEVP,"1/3/2023 1 a.m. PST",3776,3688,3145,-631
NEVP,"1/3/2023 2 a.m. PST",3679,3673,3131,-548
NEVP,"1/3/2023 3 a.m. PST",3635,3667,3121,-514
NEVP,"1/3/2023 4 a.m. PST",3629,3700,3184,-445
NEVP,"1/3/2023 5 a.m. PST",3704,3769,3164,-540
NEVP,"1/3/2023 6 a.m. PST",3877,3878,3217,-660
NEVP,"1/3/2023 7 a.m. PST",4073,4094,3440,-633
NEVP,"1/3/2023 8 a.m. PST",4103,4124,3450,-653
NEVP,"1/3/2023 9 a.m. PST",4092,4078,3504,-588
NEVP,"1/3/2023 10 a.m. PST",4132,3948,3351,-781
NEVP,"1/3/2023 11 a.m. PST",4048,3897,3464,-584
NEVP,"1/3/2023 12 p.m. PST",3935,3860,3679,-256
NEVP,"1/3/2023 1 p.m. PST",3846,3786,3735,-111
NEVP,"1/3/2023 2 p.m. PST",3856,3755,3976,120
NEVP,"1/3/2023 3 p.m. PST",3870,3810,3895,25
NEVP,"1/3/2023 4 p.m. PST",4014,3828,3736,-278
NEVP,"1/3/2023 5 p.m. PST",4231,4142,3604,-627
NEVP,"1/3/2023 6 p.m. PST",4454,4357,3950,-504
NEVP,"1/3/2023 7 p.m. PST",4442,4334,3971,-471
NEVP,"1/3/2023 8 p.m. PST",4396,4289,3958,-438
NEVP,"1/3/2023 9 p.m. PST",4325,4162,3937,-388
NEVP,"1/3/2023 10 p.m. PST",4173,4041,3450,-723
NEVP,"1/3/2023 11 p.m. PST",4012,3904,3243,-769
NEVP,"1/4/2023 12 a.m. PST",3857,3778,3328,-529
NEVP,"1/4/2023 1 a.m. PST",3753,3585,3442,-311
NEVP,"1/4/2023 2 a.m. PST",3679,3518,3554,-125
NEVP,"1/4/2023 3 a.m. PST",3644,3506,3551,-93
NEVP,"1/4/2023 4 a.m. PST",3652,3534,3548,-104
NEVP,"1/4/2023 5 a.m. PST",3706,3655,3718,12
NEVP,"1/4/2023 6 a.m. PST",3850,3763,3740,-110
NEVP,"1/4/2023 7 a.m. PST",4016,3959,3783,-233
NEVP,"1/4/2023 8 a.m. PST",4103,3945,3869,-234
NEVP,"1/4/2023 9 a.m. PST",4151,3848,3704,-447
NEVP,"1/4/2023 10 a.m. PST",4226,3872,3635,-591
NEVP,"1/4/2023 11 a.m. PST",4211,3914,3557,-654
NEVP,"1/4/2023 12 p.m. PST",4115,3849,3519,-596
NEVP,"1/4/2023 1 p.m. PST",4203,3823,3787,-416
NEVP,"1/4/2023 2 p.m. PST",4211,3852,3519,-692
NEVP,"1/4/2023 3 p.m. PST",4202,3927,3640,-562
NEVP,"1/4/2023 4 p.m. PST",4197,4045,3856,-341
NEVP,"1/4/2023 5 p.m. PST",4349,4163,3945,-404
NEVP,"1/4/2023 6 p.m. PST",4492,4357,4131,-361
NEVP,"1/4/2023 7 p.m. PST",4459,4360,4098,-361
NEVP,"1/4/2023 8 p.m. PST",4406,4315,4038,-368
NEVP,"1/4/2023 9 p.m. PST",4319,4224,3957,-362
NEVP,"1/4/2023 10 p.m. PST",4164,4093,3836,-328
NEVP,"1/4/2023 11 p.m. PST",3973,3928,3614,-359
NEVP,"1/5/2023 12 a.m. PST",3792,3817,3338,-454
NEVP,"1/5/2023 1 a.m. PST",3683,3577,3387,-296
NEVP,"1/5/2023 2 a.m. PST",3600,3503,3410,-190
NEVP,"1/5/2023 3 a.m. PST",3575,3439,3311,-264
NEVP,"1/5/2023 4 a.m. PST",3584,3428,3112,-472
NEVP,"1/5/2023 5 a.m. PST",3638,3462,3129,-509
NEVP,"1/5/2023 6 a.m. PST",3801,3632,2920,-881
NEVP,"1/5/2023 7 a.m. PST",3998,3763,3242,-756
NEVP,"1/5/2023 8 a.m. PST",4068,3899,3944,-124
NEVP,"1/5/2023 9 a.m. PST",4056,3929,4034,-22
NEVP,"1/5/2023 10 a.m. PST",4152,3917,4115,-37
NEVP,"1/5/2023 11 a.m. PST",4157,3859,4217,60
NEVP,"1/5/2023 12 p.m. PST",4175,3857,4134,-41
NEVP,"1/5/2023 1 p.m. PST",4167,3903,3954,-213
NEVP,"1/5/2023 2 p.m. PST",4108,3847,3770,-338
NEVP,"1/5/2023 3 p.m. PST",4147,3854,3673,-474
NEVP,"1/5/2023 4 p.m. PST",4168,3916,3691,-477
NEVP,"1/5/2023 5 p.m. PST",4231,4071,3877,-354
NEVP,"1/5/2023 6 p.m. PST",4438,4254,3938,-500
NEVP,"1/5/2023 7 p.m. PST",4415,4242,3924,-491
NEVP,"1/5/2023 8 p.m. PST",4358,4226,3863,-495
NEVP,"1/5/2023 9 p.m. PST",4272,4158,3408,-864
NEVP,"1/5/2023 10 p.m. PST",4137,4039,3334,-803
NEVP,"1/5/2023 11 p.m. PST",3977,3884,3249,-728
NEVP,"1/6/2023 12 a.m. PST",3835,3723,3013,-822
NEVP,"1/6/2023 1 a.m. PST",3717,3649,2701,-1016
NEVP,"1/6/2023 2 a.m. PST",3671,3580,2614,-1057
NEVP,"1/6/2023 3 a.m. PST",3630,3569,2618,-1012
NEVP,"1/6/2023 4 a.m. PST",3651,3524,2641,-1010
NEVP,"1/6/2023 5 a.m. PST",3721,3584,2660,-1061
NEVP,"1/6/2023 6 a.m. PST",3883,3736,3253,-630
NEVP,"1/6/2023 7 a.m. PST",4094,3866,3355,-739
NEVP,"1/6/2023 8 a.m. PST",4107,3934,3631,-476
NEVP,"1/6/2023 9 a.m. PST",4002,3996,3961,-41
NEVP,"1/6/2023 10 a.m. PST",3953,3910,3732,-221
NEVP,"1/6/2023 11 a.m. PST",3847,3856,3547,-300
NEVP,"1/6/2023 12 p.m. PST",3774,3785,3346,-428
NEVP,"1/6/2023 1 p.m. PST",3741,3779,3389,-352
NEVP,"1/6/2023 2 p.m. PST",3720,3738,3477,-243
NEVP,"1/6/2023 3 p.m. PST",3740,3864,3721,-19
NEVP,"1/6/2023 4 p.m. PST",3851,3899,3699,-152
NEVP,"1/6/2023 5 p.m. PST",4061,4083,3892,-169
NEVP,"1/6/2023 6 p.m. PST",4293,4204,3998,-295
NEVP,"1/6/2023 7 p.m. PST",4272,4169,4097,-175
NEVP,"1/6/2023 8 p.m. PST",4239,4172,4078,-161
NEVP,"1/6/2023 9 p.m. PST",4190,4184,4112,-78
NEVP,"1/6/2023 10 p.m. PST",4091,4056,3919,-172
NEVP,"1/6/2023 11 p.m. PST",3975,3935,3809,-166
NEVP,"1/7/2023 12 a.m. PST",3851,3776,3796,-55
NEVP,"1/7/2023 1 a.m. PST",3745,3658,3471,-274
NEVP,"1/7/2023 2 a.m. PST",3685,3551,3374,-311
NEVP,"1/7/2023 3 a.m. PST",3670,3516,3399,-271
NEVP,"1/7/2023 4 a.m. PST",3670,3505,3391,-279
NEVP,"1/7/2023 5 a.m. PST",3724,3503,3437,-287
NEVP,"1/7/2023 6 a.m. PST",3800,3577,3379,-421
NEVP,"1/7/2023 7 a.m. PST",3894,3642,3361,-533
NEVP,"1/7/2023 8 a.m. PST",3874,3688,3490,-384
NEVP,"1/7/2023 9 a.m. PST",3812,3760,3531,-281
NEVP,"1/7/2023 10 a.m. PST",3837,3864,3756,-81
NEVP,"1/7/2023 11 a.m. PST",3789,3832,3682,-107
NEVP,"1/7/2023 12 p.m. PST",3752,3742,3792,40
NEVP,"1/7/2023 1 p.m. PST",3719,3776,3759,40
NEVP,"1/7/2023 2 p.m. PST",3693,3768,3309,-384
NEVP,"1/7/2023 3 p.m. PST",3756,3811,3644,-112
NEVP,"1/7/2023 4 p.m. PST",3804,3799,3405,-399
NEVP,"1/7/2023 5 p.m. PST",4020,3920,3739,-281
NEVP,"1/7/2023 6 p.m. PST",4221,4116,3962,-259
NEVP,"1/7/2023 7 p.m. PST",4207,4125,4069,-138
NEVP,"1/7/2023 8 p.m. PST",4145,4033,3975,-170
NEVP,"1/7/2023 9 p.m. PST",4093,4018,3893,-200
NEVP,"1/7/2023 10 p.m. PST",3994,3926,3870,-124
NEVP,"1/7/2023 11 p.m. PST",3891,3820,3770,-121
NEVP,"1/8/2023 12 a.m. PST",3763,3710,3640,-123
NEVP,"1/8/2023 1 a.m. PST",3661,3669,3394,-267
NEVP,"1/8/2023 2 a.m. PST",3599,3612,3301,-298
NEVP,"1/8/2023 3 a.m. PST",3566,3578,3299,-267
NEVP,"1/8/2023 4 a.m. PST",3557,3558,3304,-253
NEVP,"1/8/2023 5 a.m. PST",3587,3551,3334,-253
NEVP,"1/8/2023 6 a.m. PST",3647,3596,3336,-311
NEVP,"1/8/2023 7 a.m. PST",3749,3616,3322,-427
NEVP,"1/8/2023 8 a.m. PST",3758,3636,3306,-452
NEVP,"1/8/2023 9 a.m. PST",3728,3706,3417,-311
NEVP,"1/8/2023 10 a.m. PST",3708,3742,3523,-185
NEVP,"1/8/2023 11 a.m. PST",3848,3729,3411,-437
NEVP,"1/8/2023 12 p.m. PST",3822,3616,2902,-920
NEVP,"1/8/2023 1 p.m. PST",3612,3558,3055,-557
NEVP,"1/8/2023 2 p.m. PST",3571,3566,3321,-250
NEVP,"1/8/2023 3 p.m. PST",3535,3584,3647,112
NEVP,"1/8/2023 4 p.m. PST",3648,3644,3714,66
NEVP,"1/8/2023 5 p.m. PST",3900,3899,3752,-148
NEVP,"1/8/2023 6 p.m. PST",4142,4183,3933,-209
NEVP,"1/8/2023 7 p.m. PST",4136,4190,3984,-152
NEVP,"1/8/2023 8 p.m. PST",4121,4132,3977,-144
NEVP,"1/8/2023 9 p.m. PST",4060,4092,3977,-83
NEVP,"1/8/2023 10 p.m. PST",3931,3990,3860,-71
NEVP,"1/8/2023 11 p.m. PST",3790,3812,3704,-86
NEVP,"1/9/2023 12 a.m. PST",3646,3652,3246,-400
NEVP,"1/9/2023 1 a.m. PST",3531,3547,3181,-350
NEVP,"1/9/2023 2 a.m. PST",3463,3534,3167,-296
NEVP,"1/9/2023 3 a.m. PST",3429,3499,3195,-234
NEVP,"1/9/2023 4 a.m. PST",3454,3491,3226,-228
NEVP,"1/9/2023 5 a.m. PST",3540,3542,3322,-218
NEVP,"1/9/2023 6 a.m. PST",3717,3720,3425,-292
NEVP,"1/9/2023 7 a.m. PST",3927,3841,3570,-357
NEVP,"1/9/2023 8 a.m. PST",4032,3951,3666,-366
NEVP,"1/9/2023 9 a.m. PST",4094,4032,3851,-243
NEVP,"1/9/2023 10 a.m. PST",4072,4073,4424,352
NEVP,"1/9/2023 11 a.m. PST",4067,4042,4373,306
NEVP,"1/9/2023 12 p.m. PST",4032,3907,4246,214
NEVP,"1/9/2023 1 p.m. PST",3991,3864,4216,225
NEVP,"1/9/2023 2 p.m. PST",4007,3944,4200,193
NEVP,"1/9/2023 3 p.m. PST",4019,3958,3702,-317
NEVP,"1/9/2023 4 p.m. PST",4063,4005,3630,-433
NEVP,"1/9/2023 5 p.m. PST",4219,4182,3643,-576
NEVP,"1/9/2023 6 p.m. PST",4345,4413,3510,-835
NEVP,"1/9/2023 7 p.m. PST",4316,4374,3477,-839
NEVP,"1/9/2023 8 p.m. PST",4259,4275,3053,-1206
NEVP,"1/9/2023 9 p.m. PST",4169,4196,2917,-1252
NEVP,"1/9/2023 10 p.m. PST",4022,4064,2925,-1097
NEVP,"1/9/2023 11 p.m. PST",3843,3868,2881,-962
NEVP,"1/10/2023 12 a.m. PST",3684,3698,3205,-479
NEVP,"1/10/2023 1 a.m. PST",3581,3507,3622,41
NEVP,"1/10/2023 2 a.m. PST",3507,3472,3560,53
NEVP,"1/10/2023 3 a.m. PST",3473,3444,3320,-153
NEVP,"1/10/2023 4 a.m. PST",3463,3427,3263,-200
NEVP,"1/10/2023 5 a.m. PST",3530,3507,3230,-300
NEVP,"1/10/2023 6 a.m. PST",3694,3659,3110,-584
NEVP,"1/10/2023 7 a.m. PST",3921,3852,2925,-996
NEVP,"1/10/2023 8 a.m. PST",3980,3845,3585,-395
NEVP,"1/10/2023 9 a.m. PST",3992,3850,3404,-588
NEVP,"1/10/2023 10 a.m. PST",4032,3852,3548,-484
NEVP,"1/10/2023 11 a.m. PST",3921,3874,3285,-636
NEVP,"1/10/2023 12 p.m. PST",3942,3855,3640,-302
NEVP,"1/10/2023 1 p.m. PST",4128,3814,3161,-967
NEVP,"1/10/2023 2 p.m. PST",4111,3762,2807,-1304
NEVP,"1/10/2023 3 p.m. PST",4141,3724,3089,-1052
NEVP,"1/10/2023 4 p.m. PST",4189,3817,3390,-799
NEVP,"1/10/2023 5 p.m. PST",4259,3950,3820,-439
NEVP,"1/10/2023 6 p.m. PST",4469,4163,4058,-411
NEVP,"1/10/2023 7 p.m. PST",4436,4195,3837,-599
NEVP,"1/10/2023 8 p.m. PST",4382,4177,3854,-528
NEVP,"1/10/2023 9 p.m. PST",4275,4112,3902,-373
NEVP,"1/10/2023 10 p.m. PST",4117,3968,3766,-351
NEVP,"1/10/2023 11 p.m. PST",3940,3775,3737,-203
NEVP,"1/11/2023 12 a.m. PST",3772,3659,3574,-198
NEVP,"1/11/2023 1 a.m. PST",3679,3475,3548,-131
NEVP,"1/11/2023 2 a.m. PST",3633,3435,3243,-390
NEVP,"1/11/2023 3 a.m. PST",3617,3424,3208,-409
NEVP,"1/11/2023 4 a.m. PST",3633,3431,3183,-450
NEVP,"1/11/2023 5 a.m. PST",3717,3534,3179,-538
NEVP,"1/11/2023 6 a.m. PST",3896,3720,3280,-616
NEVP,"1/11/2023 7 a.m. PST",4113,3920,3463,-650
NEVP,"1/11/2023 8 a.m. PST",4122,4053,3675,-447
NEVP,"1/11/2023 9 a.m. PST",4012,4025,4043,31
NEVP,"1/11/2023 10 a.m. PST",3918,3948,3896,-22
NEVP,"1/11/2023 11 a.m. PST",3824,3909,3469,-355
NEVP,"1/11/2023 12 p.m. PST",3761,3862,3279,-482
NEVP,"1/11/2023 1 p.m. PST",3699,3825,3301,-398
NEVP,"1/11/2023 2 p.m. PST",3737,3748,3417,-320
NEVP,"1/11/2023 3 p.m. PST",3835,3790,3638,-197
NEVP,"1/11/2023 4 p.m. PST",3876,3848,3452,-424
NEVP,"1/11/2023 5 p.m. PST",4097,4056,3677,-420
NEVP,"1/11/2023 6 p.m. PST",4316,4239,3644,-672
NEVP,"1/11/2023 7 p.m. PST",4310,4229,3630,-680
NEVP,"1/11/2023 8 p.m. PST",4291,4220,3890,-401
NEVP,"1/11/2023 9 p.m. PST",4236,4177,3850,-386
NEVP,"1/11/2023 10 p.m. PST",4122,4055,3602,-520
NEVP,"1/11/2023 11 p.m. PST",3949,3881,3544,-405
NEVP,"1/12/2023 12 a.m. PST",3805,3704,3552,-253
NEVP,"1/12/2023 1 a.m. PST",3703,3587,3564,-139
NEVP,"1/12/2023 2 a.m. PST",3645,3535,3704,59
NEVP,"1/12/2023 3 a.m. PST",3635,3504,3853,218
NEVP,"1/12/2023 4 a.m. PST",3656,3546,3615,-41
NEVP,"1/12/2023 5 a.m. PST",3731,3691,3595,-136
NEVP,"1/12/2023 6 a.m. PST",3919,3845,3528,-391
NEVP,"1/12/2023 7 a.m. PST",4139,3944,3508,-631
NEVP,"1/12/2023 8 a.m. PST",4163,4007,3463,-700
NEVP,"1/12/2023 9 a.m. PST",4069,3982,3573,-496
NEVP,"1/12/2023 10 a.m. PST",3946,3948,3533,-413
NEVP,"1/12/2023 11 a.m. PST",3855,3931,3399,-456
NEVP,"1/12/2023 12 p.m. PST",3763,3859,3305,-458
NEVP,"1/12/2023 1 p.m. PST",3772,3851,3286,-486
NEVP,"1/12/2023 2 p.m. PST",3747,3748,3230,-517
NEVP,"1/12/2023 3 p.m. PST",3747,3748,3593,-154
NEVP,"1/12/2023 4 p.m. PST",3850,3844,3157,-693
NEVP,"1/12/2023 5 p.m. PST",4026,3948,3149,-877
NEVP,"1/12/2023 6 p.m. PST",4264,4174,3535,-729
NEVP,"1/12/2023 7 p.m. PST",4279,4209,3524,-755
NEVP,"1/12/2023 8 p.m. PST",4245,4199,3603,-642
NEVP,"1/12/2023 9 p.m. PST",4173,4097,3642,-531
NEVP,"1/12/2023 10 p.m. PST",4061,4005,3462,-599
NEVP,"1/12/2023 11 p.m. PST",3894,3817,3355,-539
NEVP,"1/13/2023 12 a.m. PST",3750,3662,3651,-99
NEVP,"1/13/2023 1 a.m. PST",3658,3495,3637,-21
NEVP,"1/13/2023 2 a.m. PST",3610,3451,3584,-26
NEVP,"1/13/2023 3 a.m. PST",3584,3438,3368,-216
NEVP,"1/13/2023 4 a.m. PST",3612,3454,3373,-239
NEVP,"1/13/2023 5 a.m. PST",3685,3513,3605,-80
NEVP,"1/13/2023 6 a.m. PST",3852,3642,3786,-66
NEVP,"1/13/2023 7 a.m. PST",4055,3823,3810,-245
NEVP,"1/13/2023 8 a.m. PST",4093,3931,3803,-290
NEVP,"1/13/2023 9 a.m. PST",4028,3896,3440,-588
NEVP,"1/13/2023 10 a.m. PST",3988,3816,3337,-651
NEVP,"1/13/2023 11 a.m. PST",3892,3763,3308,-584
NEVP,"1/13/2023 12 p.m. PST",3846,3721,3291,-555
NEVP,"1/13/2023 1 p.m. PST",3825,3687,3239,-586
NEVP,"1/13/2023 2 p.m. PST",3819,3642,3077,-742
NEVP,"1/13/2023 3 p.m. PST",3845,3697,2796,-1049
NEVP,"1/13/2023 4 p.m. PST",3936,3732,2849,-1087
NEVP,"1/13/2023 5 p.m. PST",4088,3948,3141,-947
NEVP,"1/13/2023 6 p.m. PST",4249,4093,3884,-365
NEVP,"1/13/2023 7 p.m. PST",4231,4093,3949,-282
NEVP,"1/13/2023 8 p.m. PST",4176,4080,3984,-192
NEVP,"1/13/2023 9 p.m. PST",4123,4004,3827,-296
NEVP,"1/13/2023 10 p.m. PST",4037,3923,3559,-478
NEVP,"1/13/2023 11 p.m. PST",3911,3776,3280,-631
NEVP,"1/14/2023 12 a.m. PST",3788,3657,3174,-614
NEVP,"1/14/2023 1 a.m. PST",3684,3523,3244,-440
NEVP,"1/14/2023 2 a.m. PST",3623,3452,3167,-456
NEVP,"1/14/2023 3 a.m. PST",3585,3471,3170,-415
NEVP,"1/14/2023 4 a.m. PST",3574,3464,3155,-419
NEVP,"1/14/2023 5 a.m. PST",3589,3455,3137,-452
NEVP,"1/14/2023 6 a.m. PST",3649,3504,3387,-262
NEVP,"1/14/2023 7 a.m. PST",3750,3618,3086,-664
NEVP,"1/14/2023 8 a.m. PST",3775,3626,3367,-408
NEVP,"1/14/2023 9 a.m. PST",3815,3630,3575,-240
NEVP,"1/14/2023 10 a.m. PST",3880,3633,3742,-138
NEVP,"1/14/2023 11 a.m. PST",3943,3600,3860,-83
NEVP,"1/14/2023 12 p.m. PST",3962,3561,3904,-58
NEVP,"1/14/2023 1 p.m. PST",3994,3534,3842,-152
NEVP,"1/14/2023 2 p.m. PST",3923,3524,3855,-68
NEVP,"1/14/2023 3 p.m. PST",3931,3600,3882,-49
NEVP,"1/14/2023 4 p.m. PST",3957,3637,3955,-2
NEVP,"1/14/2023 5 p.m. PST",4121,3852,3629,-492
NEVP,"1/14/2023 6 p.m. PST",4258,4041,4014,-244
NEVP,"1/14/2023 7 p.m. PST",4236,4057,4049,-187
NEVP,"1/14/2023 8 p.m. PST",4198,3980,4056,-142
NEVP,"1/14/2023 9 p.m. PST",4139,3962,3603,-536
NEVP,"1/14/2023 10 p.m. PST",4039,3838,3236,-803
NEVP,"1/14/2023 11 p.m. PST",3927,3706,3218,-709
NEVP,"1/15/2023 12 a.m. PST",3789,3616,2875,-914
NEVP,"1/15/2023 1 a.m. PST",3683,3475,2865,-818
NEVP,"1/15/2023 2 a.m. PST",3603,3444,2671,-932
NEVP,"1/15/2023 3 a.m. PST",3551,3464,2715,-836
NEVP,"1/15/2023 4 a.m. PST",3520,3453,2607,-913
NEVP,"1/15/2023 5 a.m. PST",3537,3440,2795,-742
NEVP,"1/15/2023 6 a.m. PST",3625,3475,2800,-825
NEVP,"1/15/2023 7 a.m. PST",3709,3567,2917,-792
NEVP,"1/15/2023 8 a.m. PST",3683,3573,3331,-352
NEVP,"1/15/2023 9 a.m. PST",3615,3570,3794,179
NEVP,"1/15/2023 10 a.m. PST",3713,3550,3908,195
NEVP,"1/15/2023 11 a.m. PST",3670,3569,3896,226
NEVP,"1/15/2023 12 p.m. PST",3674,3581,3682,8
NEVP,"1/15/2023 1 p.m. PST",3684,3557,3638,-46
NEVP,"1/15/2023 2 p.m. PST",3708,3531,3523,-185
NEVP,"1/15/2023 3 p.m. PST",3738,3613,3556,-182
NEVP,"1/15/2023 4 p.m. PST",3850,3653,3740,-110
NEVP,"1/15/2023 5 p.m. PST",4036,3902,3928,-108
NEVP,"1/15/2023 6 p.m. PST",4236,4142,4022,-214
NEVP,"1/15/2023 7 p.m. PST",4205,4119,4037,-168
NEVP,"1/15/2023 8 p.m. PST",4139,4083,4074,-65
NEVP,"1/15/2023 9 p.m. PST",4075,4002,4035,-40
NEVP,"1/15/2023 10 p.m. PST",3972,3881,3835,-137
NEVP,"1/15/2023 11 p.m. PST",3857,3758,3642,-215
NEVP,"1/16/2023 12 a.m. PST",3731,3607,3325,-406
NEVP,"1/16/2023 1 a.m. PST",3620,3484,3067,-553
NEVP,"1/16/2023 2 a.m. PST",3570,3433,2789,-781
NEVP,"1/16/2023 3 a.m. PST",3550,3398,2901,-649
NEVP,"1/16/2023 4 a.m. PST",3552,3413,2956,-596
NEVP,"1/16/2023 5 a.m. PST",3626,3473,3182,-444
NEVP,"1/16/2023 6 a.m. PST",3756,3634,3294,-462
NEVP,"1/16/2023 7 a.m. PST",3870,3821,3534,-336
NEVP,"1/16/2023 8 a.m. PST",3927,3935,3789,-138
NEVP,"1/16/2023 9 a.m. PST",3929,3910,3930,1
NEVP,"1/16/2023 10 a.m. PST",3867,3843,4078,211
NEVP,"1/16/2023 11 a.m. PST",3807,3805,3713,-94
NEVP,"1/16/2023 12 p.m. PST",3905,3737,3680,-225
NEVP,"1/16/2023 1 p.m. PST",4030,3724,3866,-164
NEVP,"1/16/2023 2 p.m. PST",3811,3716,3990,179
NEVP,"1/16/2023 3 p.m. PST",3855,3789,4333,478
NEVP,"1/16/2023 4 p.m. PST",3959,3876,4347,388
NEVP,"1/16/2023 5 p.m. PST",4180,4116,4038,-142
NEVP,"1/16/2023 6 p.m. PST",4424,4326,4072,-352
NEVP,"1/16/2023 7 p.m. PST",4412,4275,4187,-225
NEVP,"1/16/2023 8 p.m. PST",4375,4243,4120,-255
NEVP,"1/16/2023 9 p.m. PST",4260,4153,3970,-290
NEVP,"1/16/2023 10 p.m. PST",4114,3982,3831,-283
NEVP,"1/16/2023 11 p.m. PST",3937,3815,3682,-255
NEVP,"1/17/2023 12 a.m. PST",3774,3661,3577,-197
NEVP,"1/17/2023 1 a.m. PST",3669,3570,3547,-122
NEVP,"1/17/2023 2 a.m. PST",3593,3542,3370,-223
NEVP,"1/17/2023 3 a.m. PST",3571,3573,3417,-154
NEVP,"1/17/2023 4 a.m. PST",3598,3582,3245,-353
NEVP,"1/17/2023 5 a.m. PST",3677,3669,3054,-623
NEVP,"1/17/2023 6 a.m. PST",3853,3811,3033,-820
NEVP,"1/17/2023 7 a.m. PST",4092,4002,3262,-830
NEVP,"1/17/2023 8 a.m. PST",4126,4073,4053,-73
NEVP,"1/17/2023 9 a.m. PST",4109,4043,3954,-155
NEVP,"1/17/2023 10 a.m. PST",4199,3955,3924,-275
NEVP,"1/17/2023 11 a.m. PST",4042,3893,3628,-414
NEVP,"1/17/2023 12 p.m. PST",3991,3783,3388,-603
NEVP,"1/17/2023 1 p.m. PST",4033,3761,3219,-814
NEVP,"1/17/2023 2 p.m. PST",3958,3708,3423,-535
NEVP,"1/17/2023 3 p.m. PST",3952,3775,3333,-619
NEVP,"1/17/2023 4 p.m. PST",4063,3818,3503,-560
NEVP,"1/17/2023 5 p.m. PST",4211,4097,4003,-208
NEVP,"1/17/2023 6 p.m. PST",4419,4348,4310,-109
NEVP,"1/17/2023 7 p.m. PST",4436,4355,4317,-119
NEVP,"1/17/2023 8 p.m. PST",4384,4285,4391,7
NEVP,"1/17/2023 9 p.m. PST",4313,4202,4312,-1
NEVP,"1/17/2023 10 p.m. PST",4183,4087,4125,-58
NEVP,"1/17/2023 11 p.m. PST",3995,3927,3701,-294
NEVP,"1/18/2023 12 a.m. PST",3857,3782,3653,-204
NEVP,"1/18/2023 1 a.m. PST",3761,3741,3619,-142
NEVP,"1/18/2023 2 a.m. PST",3703,3695,3529,-174
NEVP,"1/18/2023 3 a.m. PST",3691,3677,3517,-174
NEVP,"1/18/2023 4 a.m. PST",3725,3758,3519,-206
NEVP,"1/18/2023 5 a.m. PST",3840,3789,3534,-306
NEVP,"1/18/2023 6 a.m. PST",4030,3909,3686,-344
NEVP,"1/18/2023 7 a.m. PST",4265,4137,3946,-319
NEVP,"1/18/2023 8 a.m. PST",4283,4114,4076,-207
NEVP,"1/18/2023 9 a.m. PST",4111,4026,4043,-68
NEVP,"1/18/2023 10 a.m. PST",4541,3946,4551,10
NEVP,"1/18/2023 11 a.m. PST",3927,3858,3771,-156
NEVP,"1/18/2023 12 p.m. PST",3845,3806,3566,-279
NEVP,"1/18/2023 1 p.m. PST",3802,3800,3517,-285
NEVP,"1/18/2023 2 p.m. PST",3764,3754,3455,-309
NEVP,"1/18/2023 3 p.m. PST",3790,3843,3673,-117
NEVP,"1/18/2023 4 p.m. PST",3879,3870,3591,-288
NEVP,"1/18/2023 5 p.m. PST",4086,4122,3695,-391
NEVP,"1/18/2023 6 p.m. PST",4376,4358,4247,-129
NEVP,"1/18/2023 7 p.m. PST",4429,4361,4204,-225
NEVP,"1/18/2023 8 p.m. PST",4419,4418,4151,-268
NEVP,"1/18/2023 9 p.m. PST",4361,4303,4226,-135
NEVP,"1/18/2023 10 p.m. PST",4241,4196,4065,-176
NEVP,"1/18/2023 11 p.m. PST",4089,4009,3936,-153
NEVP,"1/19/2023 12 a.m. PST",3947,3877,3864,-83
NEVP,"1/19/2023 1 a.m. PST",3869,3645,3772,-97
NEVP,"1/19/2023 2 a.m. PST",3813,3607,3737,-76
NEVP,"1/19/2023 3 a.m. PST",3795,3604,3662,-133
NEVP,"1/19/2023 4 a.m. PST",3828,3624,3636,-192
NEVP,"1/19/2023 5 a.m. PST",3909,3638,3878,-31
NEVP,"1/19/2023 6 a.m. PST",4109,3837,4062,-47
NEVP,"1/19/2023 7 a.m. PST",4322,4063,4078,-244
NEVP,"1/19/2023 8 a.m. PST",4338,4191,4079,-259
NEVP,"1/19/2023 9 a.m. PST",4192,4123,4254,62
NEVP,"1/19/2023 10 a.m. PST",4085,4054,4287,202
NEVP,"1/19/2023 11 a.m. PST",3969,3890,4209,240
NEVP,"1/19/2023 12 p.m. PST",3865,3794,4099,234
NEVP,"1/19/2023 1 p.m. PST",3939,3922,4042,103
NEVP,"1/19/2023 2 p.m. PST",4118,3950,3587,-531
NEVP,"1/19/2023 3 p.m. PST",4149,3923,3340,-809
NEVP,"1/19/2023 4 p.m. PST",4271,4050,3526,-745
NEVP,"1/19/2023 5 p.m. PST",4385,4177,3678,-707
NEVP,"1/19/2023 6 p.m. PST",4541,4437,4259,-282
NEVP,"1/19/2023 7 p.m. PST",4535,4409,4305,-230
NEVP,"1/19/2023 8 p.m. PST",4499,4519,4260,-239
NEVP,"1/19/2023 9 p.m. PST",4445,4389,4208,-237
NEVP,"1/19/2023 10 p.m. PST",4343,4339,4023,-320
NEVP,"1/19/2023 11 p.m. PST",4157,4161,4014,-143
NEVP,"1/20/2023 12 a.m. PST",4010,4004,3998,-12
NEVP,"1/20/2023 1 a.m. PST",3932,3755,4187,255
NEVP,"1/20/2023 2 a.m. PST",3878,3693,4203,325
NEVP,"1/20/2023 3 a.m. PST",3848,3671,4210,362
NEVP,"1/20/2023 4 a.m. PST",3858,3698,4147,289
NEVP,"1/20/2023 5 a.m. PST",3930,3765,3803,-127
NEVP,"1/20/2023 6 a.m. PST",4087,3959,3644,-443
NEVP,"1/20/2023 7 a.m. PST",4306,4209,3652,-654
NEVP,"1/20/2023 8 a.m. PST",4317,4108,4156,-161
NEVP,"1/20/2023 9 a.m. PST",4194,4078,4369,175
NEVP,"1/20/2023 10 a.m. PST",4147,3957,4046,-101
NEVP,"1/20/2023 11 a.m. PST",4024,3808,3821,-203
NEVP,"1/20/2023 12 p.m. PST",3948,3715,3700,-248
NEVP,"1/20/2023 1 p.m. PST",3863,3693,3756,-107
NEVP,"1/20/2023 2 p.m. PST",3809,3591,3801,-8
NEVP,"1/20/2023 3 p.m. PST",3850,3670,4020,170
NEVP,"1/20/2023 4 p.m. PST",3930,3722,3970,40
NEVP,"1/20/2023 5 p.m. PST",4144,4019,3931,-213
NEVP,"1/20/2023 6 p.m. PST",4408,4261,4147,-261
NEVP,"1/20/2023 7 p.m. PST",4442,4241,4288,-154
NEVP,"1/20/2023 8 p.m. PST",4412,4270,4417,5
NEVP,"1/20/2023 9 p.m. PST",4365,4257,4402,37
NEVP,"1/20/2023 10 p.m. PST",4260,4201,4150,-110
NEVP,"1/20/2023 11 p.m. PST",4136,4140,4094,-42
NEVP,"1/21/2023 12 a.m. PST",4025,4025,4141,116
NEVP,"1/21/2023 1 a.m. PST",3940,3663,4111,171
NEVP,"1/21/2023 2 a.m. PST",3888,3576,4056,168
NEVP,"1/21/2023 3 a.m. PST",3886,3539,3984,98
NEVP,"1/21/2023 4 a.m. PST",3886,3558,3968,82
NEVP,"1/21/2023 5 a.m. PST",3945,3581,3987,42
NEVP,"1/21/2023 6 a.m. PST",4035,3654,3944,-91
NEVP,"1/21/2023 7 a.m. PST",4121,3774,3711,-410
NEVP,"1/21/2023 8 a.m. PST",4108,3944,4001,-107
NEVP,"1/21/2023 9 a.m. PST",4015,3860,4265,250
NEVP,"1/21/2023 10 a.m. PST",3952,3744,3701,-251
NEVP,"1/21/2023 11 a.m. PST",3828,3624,3456,-372
NEVP,"1/21/2023 12 p.m. PST",3718,3553,3367,-351
NEVP,"1/21/2023 1 p.m. PST",3669,3504,3354,-315
NEVP,"1/21/2023 2 p.m. PST",3583,3510,3490,-93
NEVP,"1/21/2023 3 p.m. PST",3597,3517,3894,297
NEVP,"1/21/2023 4 p.m. PST",3741,3497,3742,1
NEVP,"1/21/2023 5 p.m. PST",3973,3950,3740,-233
NEVP,"1/21/2023 6 p.m. PST",4263,4175,3905,-358
NEVP,"1/21/2023 7 p.m. PST",4323,4190,4150,-173
NEVP,"1/21/2023 8 p.m. PST",4281,4159,4179,-102
NEVP,"1/21/2023 9 p.m. PST",4246,4166,4124,-122
NEVP,"1/21/2023 10 p.m. PST",4192,4149,3941,-251
NEVP,"1/21/2023 11 p.m. PST",4103,4013,3954,-149
NEVP,"1/22/2023 12 a.m. PST",3999,3905,3816,-183
NEVP,"1/22/2023 1 a.m. PST",3921,3807,3824,-97
NEVP,"1/22/2023 2 a.m. PST",3881,3751,3710,-171
NEVP,"1/22/2023 3 a.m. PST",3851,3713,3675,-176
NEVP,"1/22/2023 4 a.m. PST",3857,3721,3673,-184
NEVP,"1/22/2023 5 a.m. PST",3894,3716,3685,-209
NEVP,"1/22/2023 6 a.m. PST",3957,3771,3482,-475
NEVP,"1/22/2023 7 a.m. PST",4040,3895,3361,-679
NEVP,"1/22/2023 8 a.m. PST",4012,3876,3755,-257
NEVP,"1/22/2023 9 a.m. PST",3910,3770,4038,128
NEVP,"1/22/2023 10 a.m. PST",3881,3721,3589,-292
NEVP,"1/22/2023 11 a.m. PST",3764,3653,3254,-510
NEVP,"1/22/2023 12 p.m. PST",3724,3598,3214,-510
NEVP,"1/22/2023 1 p.m. PST",3681,3531,3229,-452
NEVP,"1/22/2023 2 p.m. PST",3629,3503,3240,-389
NEVP,"1/22/2023 3 p.m. PST",3723,3555,3307,-416
NEVP,"1/22/2023 4 p.m. PST",3909,3517,3126,-783
NEVP,"1/22/2023 5 p.m. PST",4122,3951,3488,-634
NEVP,"1/22/2023 6 p.m. PST",4395,4199,4012,-383
NEVP,"1/22/2023 7 p.m. PST",4395,4217,4240,-155
NEVP,"1/22/2023 8 p.m. PST",4394,4198,4314,-80
NEVP,"1/22/2023 9 p.m. PST",4357,4154,4283,-74
NEVP,"1/22/2023 10 p.m. PST",4220,4063,4087,-133
NEVP,"1/22/2023 11 p.m. PST",4083,3899,3633,-450
NEVP,"1/23/2023 12 a.m. PST",3950,3791,3376,-574
NEVP,"1/23/2023 1 a.m. PST",3858,3715,3366,-492
NEVP,"1/23/2023 2 a.m. PST",3795,3656,3558,-237
NEVP,"1/23/2023 3 a.m. PST",3791,3592,3532,-259
NEVP,"1/23/2023 4 a.m. PST",3797,3751,3484,-313
NEVP,"1/23/2023 5 a.m. PST",3878,3755,3438,-440
NEVP,"1/23/2023 6 a.m. PST",4051,4009,3586,-465
NEVP,"1/23/2023 7 a.m. PST",4247,4194,3824,-423
NEVP,"1/23/2023 8 a.m. PST",4270,4151,4156,-114
NEVP,"1/23/2023 9 a.m. PST",4173,4022,4627,454
NEVP,"1/23/2023 10 a.m. PST",4120,3889,4802,682
NEVP,"1/23/2023 11 a.m. PST",4051,3798,4102,51
NEVP,"1/23/2023 12 p.m. PST",3957,3671,3722,-235
NEVP,"1/23/2023 1 p.m. PST",3885,3593,3618,-267
NEVP,"1/23/2023 2 p.m. PST",3817,3658,3618,-199
NEVP,"1/23/2023 3 p.m. PST",3821,3734,3734,-87
NEVP,"1/23/2023 4 p.m. PST",3930,3744,3881,-49
NEVP,"1/23/2023 5 p.m. PST",4152,4209,3821,-331
NEVP,"1/23/2023 6 p.m. PST",4447,4430,3845,-602
NEVP,"1/23/2023 7 p.m. PST",4494,4405,3983,-511
NEVP,"1/23/2023 8 p.m. PST",4472,4333,4047,-425
NEVP,"1/23/2023 9 p.m. PST",4403,4294,3973,-430
NEVP,"1/23/2023 10 p.m. PST",4255,4195,3866,-389
NEVP,"1/23/2023 11 p.m. PST",4075,4084,3803,-272
NEVP,"1/24/2023 12 a.m. PST",3924,3890,3730,-194
NEVP,"1/24/2023 1 a.m. PST",3829,3685,3627,-202
NEVP,"1/24/2023 2 a.m. PST",3770,3630,3452,-318
NEVP,"1/24/2023 3 a.m. PST",3745,3634,3406,-339
NEVP,"1/24/2023 4 a.m. PST",3775,3643,3461,-314
NEVP,"1/24/2023 5 a.m. PST",3868,3741,3535,-333
NEVP,"1/24/2023 6 a.m. PST",4045,3843,3644,-401
NEVP,"1/24/2023 7 a.m. PST",4282,3979,3801,-481
NEVP,"1/24/2023 8 a.m. PST",4278,4033,4084,-194
NEVP,"1/24/2023 9 a.m. PST",4115,3941,4459,344
NEVP,"1/24/2023 10 a.m. PST",4021,3913,4202,181
NEVP,"1/24/2023 11 a.m. PST",3869,3742,3809,-60
NEVP,"1/24/2023 12 p.m. PST",3788,3651,3492,-296
NEVP,"1/24/2023 1 p.m. PST",3715,3622,3361,-354
NEVP,"1/24/2023 2 p.m. PST",3648,3545,3466,-182
NEVP,"1/24/2023 3 p.m. PST",3678,3649,3632,-46
NEVP,"1/24/2023 4 p.m. PST",3788,3768,3697,-91
NEVP,"1/24/2023 5 p.m. PST",4003,3987,3340,-663
NEVP,"1/24/2023 6 p.m. PST",4311,4263,3543,-768
NEVP,"1/24/2023 7 p.m. PST",4393,4313,3621,-772
NEVP,"1/24/2023 8 p.m. PST",4364,4322,3738,-626
NEVP,"1/24/2023 9 p.m. PST",4300,4257,3902,-398
NEVP,"1/24/2023 10 p.m. PST",4194,4132,3723,-471
NEVP,"1/24/2023 11 p.m. PST",4024,4004,3673,-351
NEVP,"1/25/2023 12 a.m. PST",3893,3834,3589,-304
NEVP,"1/25/2023 1 a.m. PST",3809,3624,3514,-295
NEVP,"1/25/2023 2 a.m. PST",3762,3575,3481,-281
NEVP,"1/25/2023 3 a.m. PST",3785,3575,3468,-317
NEVP,"1/25/2023 4 a.m. PST",3805,3618,3461,-344
NEVP,"1/25/2023 5 a.m. PST",3899,3704,3528,-371
NEVP,"1/25/2023 6 a.m. PST",4090,3858,3765,-325
NEVP,"1/25/2023 7 a.m. PST",4305,4045,3905,-400
NEVP,"1/25/2023 8 a.m. PST",4256,4208,4093,-163
NEVP,"1/25/2023 9 a.m. PST",4067,4072,4366,299
NEVP,"1/25/2023 10 a.m. PST",3900,3934,3848,-52
NEVP,"1/25/2023 11 a.m. PST",3827,3782,3560,-267
NEVP,"1/25/2023 12 p.m. PST",3745,3668,3380,-365
NEVP,"1/25/2023 1 p.m. PST",3691,3611,3311,-380
NEVP,"1/25/2023 2 p.m. PST",3692,3539,3383,-309
NEVP,"1/25/2023 3 p.m. PST",3701,3589,3733,32
NEVP,"1/25/2023 4 p.m. PST",3794,3673,3630,-164
NEVP,"1/25/2023 5 p.m. PST",3988,3926,3454,-534
NEVP,"1/25/2023 6 p.m. PST",4288,4195,3761,-527
NEVP,"1/25/2023 7 p.m. PST",4360,4256,4083,-277
NEVP,"1/25/2023 8 p.m. PST",4335,4260,4225,-110
NEVP,"1/25/2023 9 p.m. PST",4271,4240,4190,-81
NEVP,"1/25/2023 10 p.m. PST",4136,4107,4037,-99
NEVP,"1/25/2023 11 p.m. PST",4004,3936,3974,-30
NEVP,"1/26/2023 12 a.m. PST",3850,3805,3867,17
NEVP,"1/26/2023 1 a.m. PST",3765,3715,3857,92
NEVP,"1/26/2023 2 a.m. PST",3716,3676,3818,102
NEVP,"1/26/2023 3 a.m. PST",3699,3651,3925,226
NEVP,"1/26/2023 4 a.m. PST",3722,3659,3891,169
NEVP,"1/26/2023 5 a.m. PST",3820,3715,3911,91
NEVP,"1/26/2023 6 a.m. PST",3997,3910,3960,-37
NEVP,"1/26/2023 7 a.m. PST",4220,4116,3949,-271
NEVP,"1/26/2023 8 a.m. PST",4202,4076,3803,-399
NEVP,"1/26/2023 9 a.m. PST",4047,3971,3975,-72
NEVP,"1/26/2023 10 a.m. PST",3889,3861,3877,-12
NEVP,"1/26/2023 11 a.m. PST",3808,3728,3770,-38
NEVP,"1/26/2023 12 p.m. PST",3756,3649,3665,-91
NEVP,"1/26/2023 1 p.m. PST",3699,3603,3437,-262
NEVP,"1/26/2023 2 p.m. PST",3682,3514,3562,-120
NEVP,"1/26/2023 3 p.m. PST",3697,3552,3716,19
NEVP,"1/26/2023 4 p.m. PST",3737,3674,3725,-12
NEVP,"1/26/2023 5 p.m. PST",3952,3864,3605,-347
NEVP,"1/26/2023 6 p.m. PST",4283,4149,3871,-412
NEVP,"1/26/2023 7 p.m. PST",4342,4200,4010,-332
NEVP,"1/26/2023 8 p.m. PST",4342,4191,4172,-170
NEVP,"1/26/2023 9 p.m. PST",4289,4130,4104,-185
NEVP,"1/26/2023 10 p.m. PST",4172,4003,3863,-309
NEVP,"1/26/2023 11 p.m. PST",4005,3852,3783,-222
NEVP,"1/27/2023 12 a.m. PST",3879,3746,3810,-69
NEVP,"1/27/2023 1 a.m. PST",3797,3644,3912,115
NEVP,"1/27/2023 2 a.m. PST",3741,3613,3911,170
NEVP,"1/27/2023 3 a.m. PST",3736,3571,3880,144
NEVP,"1/27/2023 4 a.m. PST",3770,3609,3933,163
NEVP,"1/27/2023 5 a.m. PST",3864,3678,3846,-18
NEVP,"1/27/2023 6 a.m. PST",4063,3844,3624,-439
NEVP,"1/27/2023 7 a.m. PST",4274,4098,3568,-706
NEVP,"1/27/2023 8 a.m. PST",4265,4074,3814,-451
NEVP,"1/27/2023 9 a.m. PST",4110,3931,3915,-195
NEVP,"1/27/2023 10 a.m. PST",3964,3818,3618,-346
NEVP,"1/27/2023 11 a.m. PST",3855,3672,3467,-388
NEVP,"1/27/2023 12 p.m. PST",3805,3552,3319,-486
NEVP,"1/27/2023 1 p.m. PST",3734,3491,3345,-389
NEVP,"1/27/2023 2 p.m. PST",3722,3486,3469,-253
NEVP,"1/27/2023 3 p.m. PST",3716,3534,3656,-60
NEVP,"1/27/2023 4 p.m. PST",3754,3554,3399,-355
NEVP,"1/27/2023 5 p.m. PST",3936,3851,3505,-431
NEVP,"1/27/2023 6 p.m. PST",4205,4142,3878,-327
NEVP,"1/27/2023 7 p.m. PST",4251,4176,4129,-122
NEVP,"1/27/2023 8 p.m. PST",4230,4167,4198,-32
NEVP,"1/27/2023 9 p.m. PST",4184,4121,4044,-140
NEVP,"1/27/2023 10 p.m. PST",4100,4060,3922,-178
NEVP,"1/27/2023 11 p.m. PST",3985,3876,3887,-98
NEVP,"1/28/2023 12 a.m. PST",3861,3763,3859,-2
NEVP,"1/28/2023 1 a.m. PST",3778,3679,3877,99
NEVP,"1/28/2023 2 a.m. PST",3741,3642,3949,208
NEVP,"1/28/2023 3 a.m. PST",3722,3603,3899,177
NEVP,"1/28/2023 4 a.m. PST",3731,3649,3937,206
NEVP,"1/28/2023 5 a.m. PST",3790,3633,3962,172
NEVP,"1/28/2023 6 a.m. PST",3875,3714,3793,-82
NEVP,"1/28/2023 7 a.m. PST",3987,3818,3687,-300
NEVP,"1/28/2023 8 a.m. PST",3955,3809,3732,-223
NEVP,"1/28/2023 9 a.m. PST",3848,3755,3363,-485
NEVP,"1/28/2023 10 a.m. PST",3748,3665,3481,-267
NEVP,"1/28/2023 11 a.m. PST",3672,3577,3413,-259
NEVP,"1/28/2023 12 p.m. PST",3602,3483,3284,-318
NEVP,"1/28/2023 1 p.m. PST",3541,3425,3270,-271
NEVP,"1/28/2023 2 p.m. PST",3522,3435,3472,-50
NEVP,"1/28/2023 3 p.m. PST",3557,3462,3688,131
NEVP,"1/28/2023 4 p.m. PST",3599,3460,3624,25
NEVP,"1/28/2023 5 p.m. PST",3801,3759,3343,-458
NEVP,"1/28/2023 6 p.m. PST",4092,4045,3669,-423
NEVP,"1/28/2023 7 p.m. PST",4143,4087,4023,-120
NEVP,"1/28/2023 8 p.m. PST",4130,4037,3878,-252
NEVP,"1/28/2023 9 p.m. PST",4102,4006,3806,-296
NEVP,"1/28/2023 10 p.m. PST",4033,3958,3675,-358
NEVP,"1/28/2023 11 p.m. PST",3943,3792,3671,-272
NEVP,"1/29/2023 12 a.m. PST",3838,3703,3513,-325
NEVP,"1/29/2023 1 a.m. PST",3753,3585,3536,-217
NEVP,"1/29/2023 2 a.m. PST",3715,3570,3520,-195
NEVP,"1/29/2023 3 a.m. PST",3692,3544,3453,-239
NEVP,"1/29/2023 4 a.m. PST",3692,3588,3312,-380
NEVP,"1/29/2023 5 a.m. PST",3726,3573,3367,-359
NEVP,"1/29/2023 6 a.m. PST",3800,3628,3555,-245
NEVP,"1/29/2023 7 a.m. PST",3893,3717,3785,-108
NEVP,"1/29/2023 8 a.m. PST",3864,3715,3649,-215
NEVP,"1/29/2023 9 a.m. PST",3818,3656,3322,-496
NEVP,"1/29/2023 10 a.m. PST",3736,3578,3237,-499
NEVP,"1/29/2023 11 a.m. PST",3726,3490,3131,-595
NEVP,"1/29/2023 12 p.m. PST",3718,3442,3128,-590
NEVP,"1/29/2023 1 p.m. PST",3679,3408,3197,-482
NEVP,"1/29/2023 2 p.m. PST",3675,3405,3479,-196
NEVP,"1/29/2023 3 p.m. PST",3709,3580,3501,-208
NEVP,"1/29/2023 4 p.m. PST",3798,3664,3646,-152
NEVP,"1/29/2023 5 p.m. PST",4001,3806,3731,-270
NEVP,"1/29/2023 6 p.m. PST",4272,4123,3986,-286
NEVP,"1/29/2023 7 p.m. PST",4295,4179,4122,-173
NEVP,"1/29/2023 8 p.m. PST",4257,4127,4086,-171
NEVP,"1/29/2023 9 p.m. PST",4182,4079,4147,-35
NEVP,"1/29/2023 10 p.m. PST",4052,3998,4060,8
NEVP,"1/29/2023 11 p.m. PST",3913,3873,3824,-89
NEVP,"1/30/2023 12 a.m. PST",3800,3715,3741,-59
NEVP,"1/30/2023 1 a.m. PST",3703,3589,3593,-110
NEVP,"1/30/2023 2 a.m. PST",3648,3554,3583,-65
NEVP,"1/30/2023 3 a.m. PST",3637,3551,3605,-32
NEVP,"1/30/2023 4 a.m. PST",3657,3626,3582,-75
NEVP,"1/30/2023 5 a.m. PST",3745,3627,3586,-159
NEVP,"1/30/2023 6 a.m. PST",3931,3828,3682,-249
NEVP,"1/30/2023 7 a.m. PST",4181,4026,3920,-261
NEVP,"1/30/2023 8 a.m. PST",4339,4103,3920,-419
NEVP,"1/30/2023 9 a.m. PST",4404,4034,4154,-250
NEVP,"1/30/2023 10 a.m. PST",4445,3950,4196,-249
NEVP,"1/30/2023 11 a.m. PST",4497,3870,4066,-431
NEVP,"1/30/2023 12 p.m. PST",4455,3737,4214,-241
NEVP,"1/30/2023 1 p.m. PST",4445,3733,4214,-231
NEVP,"1/30/2023 2 p.m. PST",4396,3754,3983,-413
NEVP,"1/30/2023 3 p.m. PST",4304,3863,3665,-639
NEVP,"1/30/2023 4 p.m. PST",4250,3922,3549,-701
NEVP,"1/30/2023 5 p.m. PST",4400,4123,3576,-824
NEVP,"1/30/2023 6 p.m. PST",4690,4430,3842,-848
NEVP,"1/30/2023 7 p.m. PST",4750,4415,4183,-567
NEVP,"1/30/2023 8 p.m. PST",4715,4335,4039,-676
NEVP,"1/30/2023 9 p.m. PST",4638,4255,3927,-711
NEVP,"1/30/2023 10 p.m. PST",4513,4121,2937,-1576
NEVP,"1/30/2023 11 p.m. PST",4329,3961,2848,-1481
NEVP,"1/31/2023 12 a.m. PST",4177,3761,3023,-1154
NEVP,"1/31/2023 1 a.m. PST",4084,3709,3112,-972
NEVP,"1/31/2023 2 a.m. PST",4063,3625,3516,-547
NEVP,"1/31/2023 3 a.m. PST",4054,3619,3542,-512
NEVP,"1/31/2023 4 a.m. PST",4083,3658,3531,-552
NEVP,"1/31/2023 5 a.m. PST",4180,3724,3662,-518
NEVP,"1/31/2023 6 a.m. PST",4366,3929,3775,-591
NEVP,"1/31/2023 7 a.m. PST",4608,4102,3649,-959
NEVP,"1/31/2023 8 a.m. PST",4578,4196,4229,-349
NEVP,"1/31/2023 9 a.m. PST",4422,4106,4257,-165
NEVP,"1/31/2023 10 a.m. PST",4252,3970,4498,246
NEVP,"1/31/2023 11 a.m. PST",4136,3856,3543,-593
NEVP,"1/31/2023 12 p.m. PST",4039,3779,3255,-784
NEVP,"1/31/2023 1 p.m. PST",3941,3737,3252,-689
NEVP,"1/31/2023 2 p.m. PST",3895,3722,3347,-548
NEVP,"1/31/2023 3 p.m. PST",3923,3678,3619,-304
NEVP,"1/31/2023 4 p.m. PST",3987,3750,3832,-155
NEVP,"1/31/2023 5 p.m. PST",4209,3923,3560,-649
NEVP,"1/31/2023 6 p.m. PST",4545,4248,3918,-627
NEVP,"1/31/2023 7 p.m. PST",4643,4356,4113,-530
NEVP,"1/31/2023 8 p.m. PST",4626,4386,4333,-293
NEVP,"1/31/2023 9 p.m. PST",4612,4309,4334,-278
NEVP,"1/31/2023 10 p.m. PST",4501,4192,3958,-543
NEVP,"1/31/2023 11 p.m. PST",4338,4043,3668,-670
NEVP,"2/1/2023 12 a.m. PST",4182,3841,3464,-718
