"BA Code","Timestamp (Hour Ending)","Demand (MWh)","Demand Forecast (MWh)","Net Generation (MWh)","Total Interchange (MWh)"
NEVP,"11/1/2022 12 a.m. PDT",3592,3363,3574,-18
NEVP,"11/1/2022 1 a.m. PDT",3461,3175,3676,215
NEVP,"11/1/2022 2 a.m. PDT",3381,3091,3595,214
NEVP,"11/1/2022 3 a.m. PDT",3335,3057,2913,-422
NEVP,"11/1/2022 4 a.m. PDT",3324,3049,2716,-608
NEVP,"11/1/2022 5 a.m. PDT",3368,3095,2593,-775
NEVP,"11/1/2022 6 a.m. PDT",3510,3250,2466,-1044
NEVP,"11/1/2022 7 a.m. PDT",3727,3455,2502,-1225
NEVP,"11/1/2022 8 a.m. PDT",3656,3621,2885,-771
NEVP,"11/1/2022 9 a.m. PDT",3613,3610,3007,-606
NEVP,"11/1/2022 10 a.m. PDT",3668,3587,3462,-206
NEVP,"11/1/2022 11 a.m. PDT",3693,3570,3317,-376
NEVP,"11/1/2022 12 p.m. PDT",3697,3577,3461,-236
NEVP,"11/1/2022 1 p.m. PDT",3809,3658,3535,-274
NEVP,"11/1/2022 2 p.m. PDT",3865,3700,3657,-208
NEVP,"11/1/2022 3 p.m. PDT",3944,3809,3700,-244
NEVP,"11/1/2022 4 p.m. PDT",4102,3850,3857,-245
NEVP,"11/1/2022 5 p.m. PDT",4229,4006,3603,-626
NEVP,"11/1/2022 6 p.m. PDT",4315,4074,3473,-842
NEVP,"11/1/2022 7 p.m. PDT",4424,4108,3490,-934
NEVP,"11/1/2022 8 p.m. PDT",4367,4074,3535,-832
NEVP,"11/1/2022 9 p.m. PDT",4261,4030,3477,-784
NEVP,"11/1/2022 10 p.m. PDT",4111,3897,3342,-769
NEVP,"11/1/2022 11 p.m. PDT",3914,3699,3311,-603
NEVP,"11/2/2022 12 a.m. PDT",3724,3501,3241,-483
NEVP,"11/2/2022 1 a.m. PDT",3585,3387,3216,-369
NEVP,"11/2/2022 2 a.m. PDT",3499,3350,3370,-129
NEVP,"11/2/2022 3 a.m. PDT",3429,3317,3353,-76
NEVP,"11/2/2022 4 a.m. PDT",3405,3286,3276,-129
NEVP,"11/2/2022 5 a.m. PDT",3453,3320,3114,-339
NEVP,"11/2/2022 6 a.m. PDT",3588,3432,3114,-474
NEVP,"11/2/2022 7 a.m. PDT",3802,3550,3117,-685
NEVP,"11/2/2022 8 a.m. PDT",3895,3651,3359,-536
NEVP,"11/2/2022 9 a.m. PDT",3966,3679,3097,-869
NEVP,"11/2/2022 10 a.m. PDT",4033,3668,3075,-958
NEVP,"11/2/2022 11 a.m. PDT",3914,3554,3166,-748
NEVP,"11/2/2022 12 p.m. PDT",3956,3532,3023,-933
NEVP,"11/2/2022 1 p.m. PDT",3893,3491,2855,-1038
NEVP,"11/2/2022 2 p.m. PDT",3809,3412,2869,-940
NEVP,"11/2/2022 3 p.m. PDT",3761,3430,2950,-811
NEVP,"11/2/2022 4 p.m. PDT",3725,3453,3192,-533
NEVP,"11/2/2022 5 p.m. PDT",3786,3610,3757,-29
NEVP,"11/2/2022 6 p.m. PDT",3817,3686,3621,-196
NEVP,"11/2/2022 7 p.m. PDT",4069,3796,3694,-375
NEVP,"11/2/2022 8 p.m. PDT",4166,3822,3818,-348
NEVP,"11/2/2022 9 p.m. PDT",4114,3849,3849,-265
NEVP,"11/2/2022 10 p.m. PDT",3981,3851,3777,-204
NEVP,"11/2/2022 11 p.m. PDT",3791,3704,3850,59
NEVP,"11/3/2022 12 a.m. PDT",3624,3528,3891,267
NEVP,"11/3/2022 1 a.m. PDT",3501,3445,3821,320
NEVP,"11/3/2022 2 a.m. PDT",3446,3411,3402,-44
NEVP,"11/3/2022 3 a.m. PDT",3415,3443,3344,-71
NEVP,"11/3/2022 4 a.m. PDT",3419,3480,3344,-75
NEVP,"11/3/2022 5 a.m. PDT",3479,3520,3350,-129
NEVP,"11/3/2022 6 a.m. PDT",3633,3632,3385,-248
NEVP,"11/3/2022 7 a.m. PDT",3822,3740,3506,-316
NEVP,"11/3/2022 8 a.m. PDT",3893,3875,3563,-330
NEVP,"11/3/2022 9 a.m. PDT",3998,3852,3309,-689
NEVP,"11/3/2022 10 a.m. PDT",4074,3796,3486,-588
NEVP,"11/3/2022 11 a.m. PDT",3982,3776,3605,-377
NEVP,"11/3/2022 12 p.m. PDT",3931,3601,3683,-248
NEVP,"11/3/2022 1 p.m. PDT",3839,3556,3612,-227
NEVP,"11/3/2022 2 p.m. PDT",3762,3442,3632,-130
NEVP,"11/3/2022 3 p.m. PDT",3718,3503,3499,-219
NEVP,"11/3/2022 4 p.m. PDT",3829,3560,3327,-502
NEVP,"11/3/2022 5 p.m. PDT",3854,3880,3531,-323
NEVP,"11/3/2022 6 p.m. PDT",3979,3865,3531,-448
NEVP,"11/3/2022 7 p.m. PDT",4183,4029,3830,-353
NEVP,"11/3/2022 8 p.m. PDT",4217,4033,4007,-210
NEVP,"11/3/2022 9 p.m. PDT",4157,3987,4049,-108
NEVP,"11/3/2022 10 p.m. PDT",4062,3979,4080,18
NEVP,"11/3/2022 11 p.m. PDT",3899,3770,4003,104
NEVP,"11/4/2022 12 a.m. PDT",3747,3613,3977,230
NEVP,"11/4/2022 1 a.m. PDT",3633,3498,3923,290
NEVP,"11/4/2022 2 a.m. PDT",3557,3449,3486,-71
NEVP,"11/4/2022 3 a.m. PDT",3503,3427,2730,-773
NEVP,"11/4/2022 4 a.m. PDT",3395,3484,2539,-856
NEVP,"11/4/2022 5 a.m. PDT",3548,3506,2628,-920
NEVP,"11/4/2022 6 a.m. PDT",3685,3598,2752,-933
NEVP,"11/4/2022 7 a.m. PDT",3919,3681,2829,-1090
NEVP,"11/4/2022 8 a.m. PDT",3916,3758,3438,-478
NEVP,"11/4/2022 9 a.m. PDT",3851,3693,3641,-210
NEVP,"11/4/2022 10 a.m. PDT",3854,3556,3789,-65
NEVP,"11/4/2022 11 a.m. PDT",3771,3544,3753,-18
NEVP,"11/4/2022 12 p.m. PDT",3717,3433,3682,-35
NEVP,"11/4/2022 1 p.m. PDT",3750,3337,3567,-183
NEVP,"11/4/2022 2 p.m. PDT",3733,3336,3351,-382
NEVP,"11/4/2022 3 p.m. PDT",3727,3402,3420,-307
NEVP,"11/4/2022 4 p.m. PDT",3748,3446,3628,-120
NEVP,"11/4/2022 5 p.m. PDT",3824,3679,3627,-197
NEVP,"11/4/2022 6 p.m. PDT",4009,3738,3448,-561
NEVP,"11/4/2022 7 p.m. PDT",4145,3852,3504,-641
NEVP,"11/4/2022 8 p.m. PDT",4108,3854,3561,-547
NEVP,"11/4/2022 9 p.m. PDT",4051,3786,3509,-542
NEVP,"11/4/2022 10 p.m. PDT",3951,3744,3509,-442
NEVP,"11/4/2022 11 p.m. PDT",3820,3601,3510,-310
NEVP,"11/5/2022 12 a.m. PDT",3578,3475,3506,-72
NEVP,"11/5/2022 1 a.m. PDT",3303,3384,3397,94
NEVP,"11/5/2022 2 a.m. PDT",3228,3327,3325,97
NEVP,"11/5/2022 3 a.m. PDT",3409,3280,3212,-197
NEVP,"11/5/2022 4 a.m. PDT",3422,3275,3186,-236
NEVP,"11/5/2022 5 a.m. PDT",3441,3293,3185,-256
NEVP,"11/5/2022 6 a.m. PDT",3518,3332,3153,-365
NEVP,"11/5/2022 7 a.m. PDT",3626,3425,3084,-542
NEVP,"11/5/2022 8 a.m. PDT",3622,3425,3154,-468
NEVP,"11/5/2022 9 a.m. PDT",3528,3389,3158,-370
NEVP,"11/5/2022 10 a.m. PDT",3602,3338,3188,-414
NEVP,"11/5/2022 11 a.m. PDT",3622,3356,3126,-496
NEVP,"11/5/2022 12 p.m. PDT",3610,3271,2955,-655
NEVP,"11/5/2022 1 p.m. PDT",3560,3217,3018,-542
NEVP,"11/5/2022 2 p.m. PDT",3514,3203,3124,-390
NEVP,"11/5/2022 3 p.m. PDT",3519,3289,3043,-476
NEVP,"11/5/2022 4 p.m. PDT",3490,3415,3098,-392
NEVP,"11/5/2022 5 p.m. PDT",3634,3590,3343,-291
NEVP,"11/5/2022 6 p.m. PDT",3704,3656,3174,-530
NEVP,"11/5/2022 7 p.m. PDT",4027,3764,3095,-932
NEVP,"11/5/2022 8 p.m. PDT",3978,3720,3188,-790
NEVP,"11/5/2022 9 p.m. PDT",3916,3655,3075,-841
NEVP,"11/5/2022 10 p.m. PDT",3826,3603,2970,-856
NEVP,"11/5/2022 11 p.m. PDT",3718,3477,2949,-769
NEVP,"11/6/2022 12 a.m. PDT",3454,3351,3129,-325
NEVP,"11/6/2022 1 a.m. PDT",3340,3353,3015,-325
NEVP,"11/6/2022 1 a.m. PST",3406,3297,3005,-401
NEVP,"11/6/2022 2 a.m. PST",3371,3297,3006,-365
NEVP,"11/6/2022 3 a.m. PST",3338,3276,2969,-369
NEVP,"11/6/2022 4 a.m. PST",3351,3233,2928,-423
NEVP,"11/6/2022 5 a.m. PST",3380,3263,2919,-461
NEVP,"11/6/2022 6 a.m. PST",3457,3237,2896,-561
NEVP,"11/6/2022 7 a.m. PST",3487,3334,2978,-509
NEVP,"11/6/2022 8 a.m. PST",3386,3341,3317,-69
NEVP,"11/6/2022 9 a.m. PST",3375,3359,3366,-9
NEVP,"11/6/2022 10 a.m. PST",3459,3532,3690,231
NEVP,"11/6/2022 11 a.m. PST",3421,3458,3570,149
NEVP,"11/6/2022 12 p.m. PST",3432,3504,3581,149
NEVP,"11/6/2022 1 p.m. PST",3480,3562,3639,159
NEVP,"11/6/2022 2 p.m. PST",3498,3715,3636,138
NEVP,"11/6/2022 3 p.m. PST",3555,3719,3613,58
NEVP,"11/6/2022 4 p.m. PST",3565,3944,3486,-79
NEVP,"11/6/2022 5 p.m. PST",3870,4107,3105,-765
NEVP,"11/6/2022 6 p.m. PST",4006,4093,3485,-521
NEVP,"11/6/2022 7 p.m. PST",3958,3931,3525,-433
NEVP,"11/6/2022 8 p.m. PST",3887,3850,3524,-363
NEVP,"11/6/2022 9 p.m. PST",3745,3779,3502,-243
NEVP,"11/6/2022 10 p.m. PST",3514,3621,3466,-48
NEVP,"11/6/2022 11 p.m. PST",3388,3457,3457,69
NEVP,"11/7/2022 12 a.m. PST",3442,3330,3353,-89
NEVP,"11/7/2022 1 a.m. PST",3440,3299,3198,-242
NEVP,"11/7/2022 2 a.m. PST",3390,3280,2756,-634
NEVP,"11/7/2022 3 a.m. PST",3362,3290,2597,-765
NEVP,"11/7/2022 4 a.m. PST",3351,3301,2605,-746
NEVP,"11/7/2022 5 a.m. PST",3269,3375,2610,-659
NEVP,"11/7/2022 6 a.m. PST",3500,3587,2617,-883
NEVP,"11/7/2022 7 a.m. PST",3671,3679,2736,-935
NEVP,"11/7/2022 8 a.m. PST",3486,3724,3881,395
NEVP,"11/7/2022 9 a.m. PST",3576,3791,3963,387
NEVP,"11/7/2022 10 a.m. PST",3688,3814,4187,499
NEVP,"11/7/2022 11 a.m. PST",3803,3757,4074,271
NEVP,"11/7/2022 12 p.m. PST",3761,3823,4200,439
NEVP,"11/7/2022 1 p.m. PST",3736,3856,4058,322
NEVP,"11/7/2022 2 p.m. PST",3826,3962,3695,-131
NEVP,"11/7/2022 3 p.m. PST",3869,3893,3460,-409
NEVP,"11/7/2022 4 p.m. PST",3897,4197,3625,-272
NEVP,"11/7/2022 5 p.m. PST",4065,4300,3865,-200
NEVP,"11/7/2022 6 p.m. PST",4403,4333,4131,-272
NEVP,"11/7/2022 7 p.m. PST",4356,4133,4190,-166
NEVP,"11/7/2022 8 p.m. PST",4276,4093,4275,-1
NEVP,"11/7/2022 9 p.m. PST",4161,4001,4088,-73
NEVP,"11/7/2022 10 p.m. PST",4007,3809,3967,-40
NEVP,"11/7/2022 11 p.m. PST",3840,3641,3695,-145
NEVP,"11/8/2022 12 a.m. PST",3684,3477,3309,-375
NEVP,"11/8/2022 1 a.m. PST",3561,3229,3147,-414
NEVP,"11/8/2022 2 a.m. PST",3490,3303,3153,-337
NEVP,"11/8/2022 3 a.m. PST",3442,3290,3235,-207
NEVP,"11/8/2022 4 a.m. PST",3444,3264,3265,-179
NEVP,"11/8/2022 5 a.m. PST",3507,3326,3282,-225
NEVP,"11/8/2022 6 a.m. PST",3658,3429,3306,-352
NEVP,"11/8/2022 7 a.m. PST",3756,3593,3364,-392
NEVP,"11/8/2022 8 a.m. PST",3646,3646,3697,51
NEVP,"11/8/2022 9 a.m. PST",3785,3671,3058,-727
NEVP,"11/8/2022 10 a.m. PST",4046,3723,3119,-927
NEVP,"11/8/2022 11 a.m. PST",3861,3833,3229,-632
NEVP,"11/8/2022 12 p.m. PST",4207,3883,3441,-766
NEVP,"11/8/2022 1 p.m. PST",3867,3857,3069,-798
NEVP,"11/8/2022 2 p.m. PST",3931,3905,2967,-964
NEVP,"11/8/2022 3 p.m. PST",4158,3886,3180,-978
NEVP,"11/8/2022 4 p.m. PST",4226,3887,3195,-1031
NEVP,"11/8/2022 5 p.m. PST",4219,3852,3479,-740
NEVP,"11/8/2022 6 p.m. PST",4297,4105,3672,-625
NEVP,"11/8/2022 7 p.m. PST",4330,4217,3787,-543
NEVP,"11/8/2022 8 p.m. PST",4284,4133,3659,-625
NEVP,"11/8/2022 9 p.m. PST",4159,4039,3637,-522
NEVP,"11/8/2022 10 p.m. PST",3998,3816,3663,-335
NEVP,"11/8/2022 11 p.m. PST",3847,3558,3629,-218
NEVP,"11/9/2022 12 a.m. PST",3684,3407,3665,-19
NEVP,"11/9/2022 1 a.m. PST",3571,3489,3730,159
NEVP,"11/9/2022 2 a.m. PST",3497,3430,3695,198
NEVP,"11/9/2022 3 a.m. PST",3461,3362,3638,177
NEVP,"11/9/2022 4 a.m. PST",3492,3352,3300,-192
NEVP,"11/9/2022 5 a.m. PST",3527,3356,3316,-211
NEVP,"11/9/2022 6 a.m. PST",3695,3494,3325,-370
NEVP,"11/9/2022 7 a.m. PST",3870,3670,3274,-596
NEVP,"11/9/2022 8 a.m. PST",3686,3615,3206,-480
NEVP,"11/9/2022 9 a.m. PST",3708,3643,3860,152
NEVP,"11/9/2022 10 a.m. PST",3768,3753,3938,170
NEVP,"11/9/2022 11 a.m. PST",3739,3895,3938,199
NEVP,"11/9/2022 12 p.m. PST",3818,3872,3938,120
NEVP,"11/9/2022 1 p.m. PST",3846,3719,3938,92
NEVP,"11/9/2022 2 p.m. PST",4226,3727,3937,-289
NEVP,"11/9/2022 3 p.m. PST",3868,3724,3621,-247
NEVP,"11/9/2022 4 p.m. PST",4044,3820,3621,-423
NEVP,"11/9/2022 5 p.m. PST",4440,3935,4090,-350
NEVP,"11/9/2022 6 p.m. PST",4206,4296,4046,-160
NEVP,"11/9/2022 7 p.m. PST",4057,4326,4126,69
NEVP,"11/9/2022 8 p.m. PST",4003,4332,4150,147
NEVP,"11/9/2022 9 p.m. PST",3928,4193,4121,193
NEVP,"11/9/2022 10 p.m. PST",3788,4030,4066,278
NEVP,"11/9/2022 11 p.m. PST",3623,3850,3544,-79
NEVP,"11/10/2022 12 a.m. PST",3574,3761,3496,-78
NEVP,"11/10/2022 1 a.m. PST",3580,3435,3490,-90
NEVP,"11/10/2022 2 a.m. PST",3554,3384,3444,-110
NEVP,"11/10/2022 3 a.m. PST",3558,3354,3620,62
NEVP,"11/10/2022 4 a.m. PST",3578,3351,3289,-289
NEVP,"11/10/2022 5 a.m. PST",3676,3347,3311,-365
NEVP,"11/10/2022 6 a.m. PST",3844,3477,3371,-473
NEVP,"11/10/2022 7 a.m. PST",4006,3659,3356,-650
NEVP,"11/10/2022 8 a.m. PST",3932,3725,4082,150
NEVP,"11/10/2022 9 a.m. PST",3873,3788,4000,127
NEVP,"11/10/2022 10 a.m. PST",3767,3898,3988,221
NEVP,"11/10/2022 11 a.m. PST",3691,3703,3673,-18
NEVP,"11/10/2022 12 p.m. PST",3692,3615,3543,-149
NEVP,"11/10/2022 1 p.m. PST",3700,3466,3631,-69
NEVP,"11/10/2022 2 p.m. PST",3588,3554,3631,43
NEVP,"11/10/2022 3 p.m. PST",3761,3807,4151,390
NEVP,"11/10/2022 4 p.m. PST",3654,3890,3977,323
NEVP,"11/10/2022 5 p.m. PST",3635,3972,3644,9
NEVP,"11/10/2022 6 p.m. PST",3717,4171,3746,29
NEVP,"11/10/2022 7 p.m. PST",3706,4263,3764,58
NEVP,"11/10/2022 8 p.m. PST",3658,4255,3764,106
NEVP,"11/10/2022 9 p.m. PST",3592,4147,3734,142
NEVP,"11/10/2022 10 p.m. PST",3488,4037,3579,91
NEVP,"11/10/2022 11 p.m. PST",3347,3881,3425,78
NEVP,"11/11/2022 12 a.m. PST",3412,3784,3076,-336
NEVP,"11/11/2022 1 a.m. PST",3441,3499,2955,-486
NEVP,"11/11/2022 2 a.m. PST",3380,3460,2945,-435
NEVP,"11/11/2022 3 a.m. PST",3336,3439,3012,-324
NEVP,"11/11/2022 4 a.m. PST",3351,3449,2967,-384
NEVP,"11/11/2022 5 a.m. PST",3422,3472,2999,-423
NEVP,"11/11/2022 6 a.m. PST",3559,3571,3020,-539
NEVP,"11/11/2022 7 a.m. PST",3694,3764,3055,-639
NEVP,"11/11/2022 8 a.m. PST",3628,3617,3514,-114
NEVP,"11/11/2022 9 a.m. PST",3669,3712,3733,64
NEVP,"11/11/2022 10 a.m. PST",3822,3771,3573,-249
NEVP,"11/11/2022 11 a.m. PST",3770,3682,3544,-226
NEVP,"11/11/2022 12 p.m. PST",3641,3686,3535,-106
NEVP,"11/11/2022 1 p.m. PST",3476,3563,3449,-27
NEVP,"11/11/2022 2 p.m. PST",3453,3769,3553,100
NEVP,"11/11/2022 3 p.m. PST",3512,3757,3642,130
NEVP,"11/11/2022 4 p.m. PST",3649,3792,3297,-352
NEVP,"11/11/2022 5 p.m. PST",3691,4035,3203,-488
NEVP,"11/11/2022 6 p.m. PST",3821,4039,3348,-473
NEVP,"11/11/2022 7 p.m. PST",3750,4005,3361,-389
NEVP,"11/11/2022 8 p.m. PST",3744,3935,3369,-375
NEVP,"11/11/2022 9 p.m. PST",3728,3846,3356,-372
NEVP,"11/11/2022 10 p.m. PST",3644,3764,3233,-411
NEVP,"11/11/2022 11 p.m. PST",3506,3620,3259,-247
NEVP,"11/12/2022 12 a.m. PST",3358,3578,3256,-102
NEVP,"11/12/2022 1 a.m. PST",3249,3493,3223,-26
NEVP,"11/12/2022 2 a.m. PST",3177,3412,3192,15
NEVP,"11/12/2022 3 a.m. PST",3140,3358,3121,-19
NEVP,"11/12/2022 4 a.m. PST",3181,3376,3046,-135
NEVP,"11/12/2022 5 a.m. PST",3208,3369,2990,-218
NEVP,"11/12/2022 6 a.m. PST",3308,3417,3058,-250
NEVP,"11/12/2022 7 a.m. PST",3429,3499,2957,-472
NEVP,"11/12/2022 8 a.m. PST",3422,3534,3631,209
NEVP,"11/12/2022 9 a.m. PST",3352,3545,3483,131
NEVP,"11/12/2022 10 a.m. PST",3409,3557,3367,-42
NEVP,"11/12/2022 11 a.m. PST",3570,3562,3368,-202
NEVP,"11/12/2022 12 p.m. PST",3495,3512,3158,-337
NEVP,"11/12/2022 1 p.m. PST",3476,3515,3197,-279
NEVP,"11/12/2022 2 p.m. PST",3527,3540,3148,-379
NEVP,"11/12/2022 3 p.m. PST",3489,3524,3466,-23
NEVP,"11/12/2022 4 p.m. PST",3545,3626,3189,-356
NEVP,"11/12/2022 5 p.m. PST",3643,3942,2881,-762
NEVP,"11/12/2022 6 p.m. PST",3726,4051,3051,-675
NEVP,"11/12/2022 7 p.m. PST",3699,4049,3146,-553
NEVP,"11/12/2022 8 p.m. PST",3629,3962,3117,-512
NEVP,"11/12/2022 9 p.m. PST",3624,3948,2922,-702
NEVP,"11/12/2022 10 p.m. PST",3587,3877,3014,-573
NEVP,"11/12/2022 11 p.m. PST",3378,3737,2800,-578
NEVP,"11/13/2022 12 a.m. PST",3306,3636,2787,-519
NEVP,"11/13/2022 1 a.m. PST",3249,3495,2715,-534
NEVP,"11/13/2022 2 a.m. PST",3274,3456,2641,-633
NEVP,"11/13/2022 3 a.m. PST",3171,3438,2555,-616
NEVP,"11/13/2022 4 a.m. PST",3172,3442,2558,-614
NEVP,"11/13/2022 5 a.m. PST",3192,3420,2587,-605
NEVP,"11/13/2022 6 a.m. PST",3262,3459,2618,-644
NEVP,"11/13/2022 7 a.m. PST",3268,3454,2679,-589
NEVP,"11/13/2022 8 a.m. PST",3260,3477,2903,-357
NEVP,"11/13/2022 9 a.m. PST",3336,3484,3025,-311
NEVP,"11/13/2022 10 a.m. PST",3511,3512,3046,-465
NEVP,"11/13/2022 11 a.m. PST",3785,3528,3016,-769
NEVP,"11/13/2022 12 p.m. PST",3686,3514,3026,-660
NEVP,"11/13/2022 1 p.m. PST",3719,3457,3157,-562
NEVP,"11/13/2022 2 p.m. PST",3586,3491,3374,-212
NEVP,"11/13/2022 3 p.m. PST",3438,3536,3519,81
NEVP,"11/13/2022 4 p.m. PST",3393,3556,2820,-573
NEVP,"11/13/2022 5 p.m. PST",3702,3902,2484,-1218
NEVP,"11/13/2022 6 p.m. PST",3967,4058,3055,-912
NEVP,"11/13/2022 7 p.m. PST",3945,4086,3144,-801
NEVP,"11/13/2022 8 p.m. PST",3922,3999,3176,-746
NEVP,"11/13/2022 9 p.m. PST",3818,3979,3123,-695
NEVP,"11/13/2022 10 p.m. PST",3712,3886,3107,-605
NEVP,"11/13/2022 11 p.m. PST",3559,3752,2981,-578
NEVP,"11/14/2022 12 a.m. PST",3439,3623,2944,-495
NEVP,"11/14/2022 1 a.m. PST",3365,3491,2935,-430
NEVP,"11/14/2022 2 a.m. PST",3326,3423,2909,-417
NEVP,"11/14/2022 3 a.m. PST",3314,3381,2888,-426
NEVP,"11/14/2022 4 a.m. PST",3295,3437,2890,-405
NEVP,"11/14/2022 5 a.m. PST",3417,3478,3089,-328
NEVP,"11/14/2022 6 a.m. PST",3545,3613,3209,-336
NEVP,"11/14/2022 7 a.m. PST",3761,3712,3287,-474
NEVP,"11/14/2022 8 a.m. PST",4067,3812,3736,-331
NEVP,"11/14/2022 9 a.m. PST",4066,3798,4006,-60
NEVP,"11/14/2022 10 a.m. PST",3871,3764,3786,-85
NEVP,"11/14/2022 11 a.m. PST",3864,3742,3613,-251
NEVP,"11/14/2022 12 p.m. PST",3860,3665,3639,-221
NEVP,"11/14/2022 1 p.m. PST",3614,3658,3586,-28
NEVP,"11/14/2022 2 p.m. PST",3587,3744,3642,55
NEVP,"11/14/2022 3 p.m. PST",3857,3784,4047,190
NEVP,"11/14/2022 4 p.m. PST",3836,3802,3753,-83
NEVP,"11/14/2022 5 p.m. PST",4041,4164,3308,-733
NEVP,"11/14/2022 6 p.m. PST",4266,4292,3827,-439
NEVP,"11/14/2022 7 p.m. PST",4263,4276,3969,-294
NEVP,"11/14/2022 8 p.m. PST",4222,4203,3844,-378
NEVP,"11/14/2022 9 p.m. PST",4189,4145,3739,-450
NEVP,"11/14/2022 10 p.m. PST",4044,4015,3698,-346
NEVP,"11/14/2022 11 p.m. PST",3877,3831,3453,-424
NEVP,"11/15/2022 12 a.m. PST",3732,3643,3356,-376
NEVP,"11/15/2022 1 a.m. PST",3671,3490,3087,-584
NEVP,"11/15/2022 2 a.m. PST",3573,3435,2886,-687
NEVP,"11/15/2022 3 a.m. PST",3565,3406,3070,-495
NEVP,"11/15/2022 4 a.m. PST",3626,3452,3006,-620
NEVP,"11/15/2022 5 a.m. PST",3686,3506,3071,-615
NEVP,"11/15/2022 6 a.m. PST",3905,3655,3345,-560
NEVP,"11/15/2022 7 a.m. PST",3994,3755,3523,-471
NEVP,"11/15/2022 8 a.m. PST",3992,3658,3859,-133
NEVP,"11/15/2022 9 a.m. PST",3790,3564,3957,167
NEVP,"11/15/2022 10 a.m. PST",3743,3589,3819,76
NEVP,"11/15/2022 11 a.m. PST",3700,3575,3571,-129
NEVP,"11/15/2022 12 p.m. PST",3719,3574,3522,-197
NEVP,"11/15/2022 1 p.m. PST",3649,3486,3512,-137
NEVP,"11/15/2022 2 p.m. PST",3686,3478,3662,-24
NEVP,"11/15/2022 3 p.m. PST",3694,3495,3883,189
NEVP,"11/15/2022 4 p.m. PST",3935,3555,3699,-236
NEVP,"11/15/2022 5 p.m. PST",4050,3780,3545,-505
NEVP,"11/15/2022 6 p.m. PST",4324,3917,3858,-466
NEVP,"11/15/2022 7 p.m. PST",4361,3933,3928,-433
NEVP,"11/15/2022 8 p.m. PST",4308,3926,3884,-424
NEVP,"11/15/2022 9 p.m. PST",4255,3878,3795,-460
NEVP,"11/15/2022 10 p.m. PST",4087,3776,3633,-454
NEVP,"11/15/2022 11 p.m. PST",3915,3607,3407,-508
NEVP,"11/16/2022 12 a.m. PST",3769,3451,3315,-454
NEVP,"11/16/2022 1 a.m. PST",3651,3474,3265,-386
NEVP,"11/16/2022 2 a.m. PST",3630,3465,3320,-310
NEVP,"11/16/2022 3 a.m. PST",3635,3456,3363,-272
NEVP,"11/16/2022 4 a.m. PST",3632,3470,3364,-268
NEVP,"11/16/2022 5 a.m. PST",3734,3551,3595,-139
NEVP,"11/16/2022 6 a.m. PST",3899,3704,3542,-357
NEVP,"11/16/2022 7 a.m. PST",4025,3837,3445,-580
NEVP,"11/16/2022 8 a.m. PST",3983,3624,3695,-288
NEVP,"11/16/2022 9 a.m. PST",3810,3531,3611,-199
NEVP,"11/16/2022 10 a.m. PST",3777,3484,3516,-261
NEVP,"11/16/2022 11 a.m. PST",3773,3433,3550,-223
NEVP,"11/16/2022 12 p.m. PST",3732,3442,3535,-197
NEVP,"11/16/2022 1 p.m. PST",3667,3414,3560,-107
NEVP,"11/16/2022 2 p.m. PST",3615,3475,3591,-24
NEVP,"11/16/2022 3 p.m. PST",3684,3502,3770,86
NEVP,"11/16/2022 4 p.m. PST",3965,3592,3613,-352
NEVP,"11/16/2022 5 p.m. PST",4085,3872,3599,-486
NEVP,"11/16/2022 6 p.m. PST",4290,3993,3775,-515
NEVP,"11/16/2022 7 p.m. PST",4284,3977,3762,-522
NEVP,"11/16/2022 8 p.m. PST",4246,3970,3829,-417
NEVP,"11/16/2022 9 p.m. PST",4185,3920,3729,-456
NEVP,"11/16/2022 10 p.m. PST",4069,3805,3559,-510
NEVP,"11/16/2022 11 p.m. PST",3906,3571,3417,-489
NEVP,"11/17/2022 12 a.m. PST",3762,3446,3282,-480
NEVP,"11/17/2022 1 a.m. PST",3669,3401,3272,-397
NEVP,"11/17/2022 2 a.m. PST",3627,3324,3232,-395
NEVP,"11/17/2022 3 a.m. PST",3614,3329,3331,-283
NEVP,"11/17/2022 4 a.m. PST",3640,3359,3407,-233
NEVP,"11/17/2022 5 a.m. PST",3745,3439,3349,-396
NEVP,"11/17/2022 6 a.m. PST",3932,3629,3250,-682
NEVP,"11/17/2022 7 a.m. PST",4096,3728,3460,-636
NEVP,"11/17/2022 8 a.m. PST",4034,3752,3915,-119
NEVP,"11/17/2022 9 a.m. PST",3900,3626,4040,140
NEVP,"11/17/2022 10 a.m. PST",3777,3575,3685,-92
NEVP,"11/17/2022 11 a.m. PST",3725,3559,3551,-174
NEVP,"11/17/2022 12 p.m. PST",3673,3553,3360,-313
NEVP,"11/17/2022 1 p.m. PST",3608,3450,3372,-236
NEVP,"11/17/2022 2 p.m. PST",3668,3456,3513,-155
NEVP,"11/17/2022 3 p.m. PST",3685,3465,3816,131
NEVP,"11/17/2022 4 p.m. PST",3791,3615,3752,-39
NEVP,"11/17/2022 5 p.m. PST",4041,3666,3418,-623
NEVP,"11/17/2022 6 p.m. PST",4227,3813,3742,-485
NEVP,"11/17/2022 7 p.m. PST",4222,3859,3878,-344
NEVP,"11/17/2022 8 p.m. PST",4210,3785,3802,-408
NEVP,"11/17/2022 9 p.m. PST",4162,3731,3645,-517
NEVP,"11/17/2022 10 p.m. PST",4051,3630,3538,-513
NEVP,"11/17/2022 11 p.m. PST",3881,3455,3385,-496
NEVP,"11/18/2022 12 a.m. PST",3730,3377,3398,-332
NEVP,"11/18/2022 1 a.m. PST",3660,3480,3197,-463
NEVP,"11/18/2022 2 a.m. PST",3616,3452,3098,-518
NEVP,"11/18/2022 3 a.m. PST",3589,3442,3211,-378
NEVP,"11/18/2022 4 a.m. PST",3609,3472,3184,-425
NEVP,"11/18/2022 5 a.m. PST",3685,3510,3151,-534
NEVP,"11/18/2022 6 a.m. PST",3851,3620,3276,-575
NEVP,"11/18/2022 7 a.m. PST",4008,3803,3469,-539
NEVP,"11/18/2022 8 a.m. PST",4030,3650,3867,-163
NEVP,"11/18/2022 9 a.m. PST",4006,3553,3959,-47
NEVP,"11/18/2022 10 a.m. PST",4012,3564,3944,-68
NEVP,"11/18/2022 11 a.m. PST",3945,3579,3779,-166
NEVP,"11/18/2022 12 p.m. PST",3890,3504,3719,-171
NEVP,"11/18/2022 1 p.m. PST",3805,3436,3767,-38
NEVP,"11/18/2022 2 p.m. PST",3619,3416,3707,88
NEVP,"11/18/2022 3 p.m. PST",3794,3448,3839,45
NEVP,"11/18/2022 4 p.m. PST",3938,3676,3806,-132
NEVP,"11/18/2022 5 p.m. PST",4150,3729,3777,-373
NEVP,"11/18/2022 6 p.m. PST",4340,3910,3929,-411
NEVP,"11/18/2022 7 p.m. PST",4291,3919,3796,-495
NEVP,"11/18/2022 8 p.m. PST",4245,3878,3753,-492
NEVP,"11/18/2022 9 p.m. PST",4178,3847,3545,-633
NEVP,"11/18/2022 10 p.m. PST",4093,3789,3537,-556
NEVP,"11/18/2022 11 p.m. PST",3963,3677,3314,-649
NEVP,"11/19/2022 12 a.m. PST",3842,3533,3356,-486
NEVP,"11/19/2022 1 a.m. PST",3733,3334,3405,-328
NEVP,"11/19/2022 2 a.m. PST",3675,3282,3440,-235
NEVP,"11/19/2022 3 a.m. PST",3653,3230,3454,-199
NEVP,"11/19/2022 4 a.m. PST",3651,3278,3376,-275
NEVP,"11/19/2022 5 a.m. PST",3703,3331,2880,-823
NEVP,"11/19/2022 6 a.m. PST",3799,3421,2700,-1099
NEVP,"11/19/2022 7 a.m. PST",3853,3507,2723,-1130
NEVP,"11/19/2022 8 a.m. PST",3793,3516,3345,-448
NEVP,"11/19/2022 9 a.m. PST",3740,3399,3905,165
NEVP,"11/19/2022 10 a.m. PST",3708,3356,3535,-173
NEVP,"11/19/2022 11 a.m. PST",3654,3371,3404,-250
NEVP,"11/19/2022 12 p.m. PST",3588,3334,3397,-191
NEVP,"11/19/2022 1 p.m. PST",3546,3248,3398,-148
NEVP,"11/19/2022 2 p.m. PST",3535,3290,3565,30
NEVP,"11/19/2022 3 p.m. PST",3579,3289,3792,213
NEVP,"11/19/2022 4 p.m. PST",3734,3439,3524,-210
NEVP,"11/19/2022 5 p.m. PST",4016,3633,3287,-729
NEVP,"11/19/2022 6 p.m. PST",4216,3822,3497,-719
NEVP,"11/19/2022 7 p.m. PST",4213,3842,3435,-778
NEVP,"11/19/2022 8 p.m. PST",4182,3811,3431,-751
NEVP,"11/19/2022 9 p.m. PST",4159,3802,3470,-689
NEVP,"11/19/2022 10 p.m. PST",4085,3764,3200,-885
NEVP,"11/19/2022 11 p.m. PST",3981,3621,3081,-900
NEVP,"11/20/2022 12 a.m. PST",3866,3506,3046,-820
NEVP,"11/20/2022 1 a.m. PST",3782,3396,2843,-939
NEVP,"11/20/2022 2 a.m. PST",3740,3417,2633,-1107
NEVP,"11/20/2022 3 a.m. PST",3708,3363,2550,-1158
NEVP,"11/20/2022 4 a.m. PST",3709,3369,2608,-1101
NEVP,"11/20/2022 5 a.m. PST",3753,3350,2669,-1084
NEVP,"11/20/2022 6 a.m. PST",3846,3473,2405,-1441
NEVP,"11/20/2022 7 a.m. PST",3885,3469,2405,-1480
NEVP,"11/20/2022 8 a.m. PST",3814,3447,3120,-694
NEVP,"11/20/2022 9 a.m. PST",3710,3397,3353,-357
NEVP,"11/20/2022 10 a.m. PST",3701,3364,3355,-346
NEVP,"11/20/2022 11 a.m. PST",3629,3369,3302,-327
NEVP,"11/20/2022 12 p.m. PST",3572,3313,3201,-371
NEVP,"11/20/2022 1 p.m. PST",3525,3300,3282,-243
NEVP,"11/20/2022 2 p.m. PST",3500,3360,3433,-67
NEVP,"11/20/2022 3 p.m. PST",3568,3438,3647,79
NEVP,"11/20/2022 4 p.m. PST",3707,3516,3292,-415
NEVP,"11/20/2022 5 p.m. PST",3979,3745,3172,-807
NEVP,"11/20/2022 6 p.m. PST",4186,3951,3320,-866
NEVP,"11/20/2022 7 p.m. PST",4174,4010,3413,-761
NEVP,"11/20/2022 8 p.m. PST",4147,3989,3407,-740
NEVP,"11/20/2022 9 p.m. PST",4103,3923,3450,-653
NEVP,"11/20/2022 10 p.m. PST",4006,3839,3377,-629
NEVP,"11/20/2022 11 p.m. PST",3881,3674,3264,-617
NEVP,"11/21/2022 12 a.m. PST",3757,3538,3228,-529
NEVP,"11/21/2022 1 a.m. PST",3678,3279,2957,-721
NEVP,"11/21/2022 2 a.m. PST",3644,3341,2903,-741
NEVP,"11/21/2022 3 a.m. PST",3637,3316,2880,-757
NEVP,"11/21/2022 4 a.m. PST",3677,3343,2831,-846
NEVP,"11/21/2022 5 a.m. PST",3780,3421,2980,-800
NEVP,"11/21/2022 6 a.m. PST",3908,3616,3120,-788
NEVP,"11/21/2022 7 a.m. PST",4071,3708,3241,-830
NEVP,"11/21/2022 8 a.m. PST",4037,3783,3514,-523
NEVP,"11/21/2022 9 a.m. PST",3959,3709,3558,-401
NEVP,"11/21/2022 10 a.m. PST",3910,3609,3525,-385
NEVP,"11/21/2022 11 a.m. PST",3798,3579,3309,-489
NEVP,"11/21/2022 12 p.m. PST",3749,3498,3298,-451
NEVP,"11/21/2022 1 p.m. PST",3718,3509,3267,-451
NEVP,"11/21/2022 2 p.m. PST",3700,3567,3431,-269
NEVP,"11/21/2022 3 p.m. PST",3765,3626,3367,-398
NEVP,"11/21/2022 4 p.m. PST",3865,3717,2905,-960
NEVP,"11/21/2022 5 p.m. PST",4135,3921,2925,-1210
NEVP,"11/21/2022 6 p.m. PST",4331,4110,3179,-1152
NEVP,"11/21/2022 7 p.m. PST",4334,4155,3349,-985
NEVP,"11/21/2022 8 p.m. PST",4301,4120,3529,-772
NEVP,"11/21/2022 9 p.m. PST",4248,4028,3638,-610
NEVP,"11/21/2022 10 p.m. PST",4137,3903,3488,-649
NEVP,"11/21/2022 11 p.m. PST",3984,3729,3330,-654
NEVP,"11/22/2022 12 a.m. PST",3835,3548,3247,-588
NEVP,"11/22/2022 1 a.m. PST",3760,3446,3107,-653
NEVP,"11/22/2022 2 a.m. PST",3713,3396,2966,-747
NEVP,"11/22/2022 3 a.m. PST",3691,3376,2956,-735
NEVP,"11/22/2022 4 a.m. PST",3702,3388,2889,-813
NEVP,"11/22/2022 5 a.m. PST",3786,3488,3090,-696
NEVP,"11/22/2022 6 a.m. PST",3967,3652,3279,-688
NEVP,"11/22/2022 7 a.m. PST",4146,3839,3385,-761
NEVP,"11/22/2022 8 a.m. PST",4126,3871,3903,-223
NEVP,"11/22/2022 9 a.m. PST",3983,3796,4209,226
NEVP,"11/22/2022 10 a.m. PST",3832,3762,3843,11
NEVP,"11/22/2022 11 a.m. PST",3809,3633,3379,-430
NEVP,"11/22/2022 12 p.m. PST",3741,3579,3415,-326
NEVP,"11/22/2022 1 p.m. PST",3734,3499,3361,-373
NEVP,"11/22/2022 2 p.m. PST",3757,3489,3465,-292
NEVP,"11/22/2022 3 p.m. PST",3771,3562,3510,-261
NEVP,"11/22/2022 4 p.m. PST",3850,3689,3333,-517
NEVP,"11/22/2022 5 p.m. PST",4103,3875,3169,-934
NEVP,"11/22/2022 6 p.m. PST",4275,4041,3324,-951
NEVP,"11/22/2022 7 p.m. PST",4269,4053,3409,-860
NEVP,"11/22/2022 8 p.m. PST",4260,4072,3395,-865
NEVP,"11/22/2022 9 p.m. PST",4198,3999,3332,-866
NEVP,"11/22/2022 10 p.m. PST",4091,3882,3270,-821
NEVP,"11/22/2022 11 p.m. PST",3948,3744,3093,-855
NEVP,"11/23/2022 12 a.m. PST",3805,3614,3136,-669
NEVP,"11/23/2022 1 a.m. PST",3704,3465,3111,-593
NEVP,"11/23/2022 2 a.m. PST",3633,3436,3069,-564
NEVP,"11/23/2022 3 a.m. PST",3624,3395,3096,-528
NEVP,"11/23/2022 4 a.m. PST",3655,3419,3128,-527
NEVP,"11/23/2022 5 a.m. PST",3736,3515,3105,-631
NEVP,"11/23/2022 6 a.m. PST",3891,3704,3095,-796
NEVP,"11/23/2022 7 a.m. PST",4006,3881,3217,-789
NEVP,"11/23/2022 8 a.m. PST",4038,3881,3612,-426
NEVP,"11/23/2022 9 a.m. PST",3931,3785,4296,365
NEVP,"11/23/2022 10 a.m. PST",3892,3689,3817,-75
NEVP,"11/23/2022 11 a.m. PST",3791,3567,3437,-354
NEVP,"11/23/2022 12 p.m. PST",3732,3527,3359,-373
NEVP,"11/23/2022 1 p.m. PST",3709,3488,3517,-192
NEVP,"11/23/2022 2 p.m. PST",3686,3525,3603,-83
NEVP,"11/23/2022 3 p.m. PST",3718,3570,3906,188
NEVP,"11/23/2022 4 p.m. PST",3833,3706,3546,-287
NEVP,"11/23/2022 5 p.m. PST",4056,3841,3438,-618
NEVP,"11/23/2022 6 p.m. PST",4202,3983,3739,-463
NEVP,"11/23/2022 7 p.m. PST",4173,3953,3682,-491
NEVP,"11/23/2022 8 p.m. PST",4125,3970,3643,-482
NEVP,"11/23/2022 9 p.m. PST",4072,3894,3678,-394
NEVP,"11/23/2022 10 p.m. PST",3974,3793,3607,-367
NEVP,"11/23/2022 11 p.m. PST",3862,3655,3595,-267
NEVP,"11/24/2022 12 a.m. PST",3730,3528,3567,-163
NEVP,"11/24/2022 1 a.m. PST",3617,3430,3353,-264
NEVP,"11/24/2022 2 a.m. PST",3540,3383,3103,-437
NEVP,"11/24/2022 3 a.m. PST",3489,3377,3153,-336
NEVP,"11/24/2022 4 a.m. PST",3492,3403,3314,-178
NEVP,"11/24/2022 5 a.m. PST",3529,3475,3312,-217
NEVP,"11/24/2022 6 a.m. PST",3601,3560,3349,-252
NEVP,"11/24/2022 7 a.m. PST",3642,3740,3386,-256
NEVP,"11/24/2022 8 a.m. PST",3589,3678,3450,-139
NEVP,"11/24/2022 9 a.m. PST",3553,3655,3611,58
NEVP,"11/24/2022 10 a.m. PST",3605,3564,3492,-113
NEVP,"11/24/2022 11 a.m. PST",3594,3482,3488,-106
NEVP,"11/24/2022 12 p.m. PST",3593,3463,3353,-240
NEVP,"11/24/2022 1 p.m. PST",3602,3446,3478,-124
NEVP,"11/24/2022 2 p.m. PST",3599,3449,3539,-60
NEVP,"11/24/2022 3 p.m. PST",3625,3550,3661,36
NEVP,"11/24/2022 4 p.m. PST",3703,3657,3212,-491
NEVP,"11/24/2022 5 p.m. PST",3854,3845,2918,-936
NEVP,"11/24/2022 6 p.m. PST",3910,4003,3353,-557
NEVP,"11/24/2022 7 p.m. PST",3828,3999,3442,-386
NEVP,"11/24/2022 8 p.m. PST",3798,3960,3403,-395
NEVP,"11/24/2022 9 p.m. PST",3782,3930,3421,-361
NEVP,"11/24/2022 10 p.m. PST",3744,3868,3425,-319
NEVP,"11/24/2022 11 p.m. PST",3680,3722,3385,-295
NEVP,"11/25/2022 12 a.m. PST",3601,3580,3397,-204
NEVP,"11/25/2022 1 a.m. PST",3524,3471,3370,-154
NEVP,"11/25/2022 2 a.m. PST",3483,3402,3387,-96
NEVP,"11/25/2022 3 a.m. PST",3466,3381,3502,36
NEVP,"11/25/2022 4 a.m. PST",3494,3400,3483,-11
NEVP,"11/25/2022 5 a.m. PST",3549,3450,3364,-185
NEVP,"11/25/2022 6 a.m. PST",3659,3542,3386,-273
NEVP,"11/25/2022 7 a.m. PST",3735,3742,3193,-542
NEVP,"11/25/2022 8 a.m. PST",3649,3702,3453,-196
NEVP,"11/25/2022 9 a.m. PST",3574,3648,3393,-181
NEVP,"11/25/2022 10 a.m. PST",3581,3573,3460,-121
NEVP,"11/25/2022 11 a.m. PST",3509,3508,3617,108
NEVP,"11/25/2022 12 p.m. PST",3453,3436,3618,165
NEVP,"11/25/2022 1 p.m. PST",3456,3421,3567,111
NEVP,"11/25/2022 2 p.m. PST",3444,3419,3802,358
NEVP,"11/25/2022 3 p.m. PST",3537,3535,4048,511
NEVP,"11/25/2022 4 p.m. PST",3622,3615,3295,-327
NEVP,"11/25/2022 5 p.m. PST",3866,3804,3327,-539
NEVP,"11/25/2022 6 p.m. PST",4033,3913,3420,-613
NEVP,"11/25/2022 7 p.m. PST",4027,3947,3209,-818
NEVP,"11/25/2022 8 p.m. PST",4021,3898,3427,-594
NEVP,"11/25/2022 9 p.m. PST",3986,3827,3764,-222
NEVP,"11/25/2022 10 p.m. PST",3928,3777,3651,-277
NEVP,"11/25/2022 11 p.m. PST",3847,3681,3569,-278
NEVP,"11/26/2022 12 a.m. PST",3741,3558,3437,-304
NEVP,"11/26/2022 1 a.m. PST",3660,3417,3431,-229
NEVP,"11/26/2022 2 a.m. PST",3601,3350,3451,-150
NEVP,"11/26/2022 3 a.m. PST",3554,3334,3359,-195
NEVP,"11/26/2022 4 a.m. PST",3544,3337,3343,-201
NEVP,"11/26/2022 5 a.m. PST",3573,3370,3333,-240
NEVP,"11/26/2022 6 a.m. PST",3654,3467,3280,-374
NEVP,"11/26/2022 7 a.m. PST",3712,3571,3046,-666
NEVP,"11/26/2022 8 a.m. PST",3664,3534,2877,-787
NEVP,"11/26/2022 9 a.m. PST",3619,3506,3257,-362
NEVP,"11/26/2022 10 a.m. PST",3632,3464,3379,-253
NEVP,"11/26/2022 11 a.m. PST",3585,3411,3341,-244
NEVP,"11/26/2022 12 p.m. PST",3615,3310,3343,-272
NEVP,"11/26/2022 1 p.m. PST",3730,3303,3132,-598
NEVP,"11/26/2022 2 p.m. PST",3668,3303,3008,-660
NEVP,"11/26/2022 3 p.m. PST",3686,3394,3501,-185
NEVP,"11/26/2022 4 p.m. PST",3758,3557,3113,-645
NEVP,"11/26/2022 5 p.m. PST",3959,3757,3368,-591
NEVP,"11/26/2022 6 p.m. PST",4124,3900,3464,-660
NEVP,"11/26/2022 7 p.m. PST",4106,3932,3542,-564
NEVP,"11/26/2022 8 p.m. PST",4062,3886,3537,-525
NEVP,"11/26/2022 9 p.m. PST",4023,3852,3285,-738
NEVP,"11/26/2022 10 p.m. PST",3946,3772,3288,-658
NEVP,"11/26/2022 11 p.m. PST",3855,3673,3392,-463
NEVP,"11/27/2022 12 a.m. PST",3741,3528,3459,-282
NEVP,"11/27/2022 1 a.m. PST",3652,3396,3279,-373
NEVP,"11/27/2022 2 a.m. PST",3594,3354,3199,-395
NEVP,"11/27/2022 3 a.m. PST",3557,3330,3174,-383
NEVP,"11/27/2022 4 a.m. PST",3550,3326,3193,-357
NEVP,"11/27/2022 5 a.m. PST",3592,3346,3178,-414
NEVP,"11/27/2022 6 a.m. PST",3665,3398,3079,-586
NEVP,"11/27/2022 7 a.m. PST",3721,3506,3038,-683
NEVP,"11/27/2022 8 a.m. PST",3650,3441,3426,-224
NEVP,"11/27/2022 9 a.m. PST",3579,3431,3537,-42
NEVP,"11/27/2022 10 a.m. PST",3587,3401,3728,141
NEVP,"11/27/2022 11 a.m. PST",3519,3374,3603,84
NEVP,"11/27/2022 12 p.m. PST",3476,3313,3340,-136
NEVP,"11/27/2022 1 p.m. PST",3467,3297,3509,42
NEVP,"11/27/2022 2 p.m. PST",3465,3344,3608,143
NEVP,"11/27/2022 3 p.m. PST",3528,3440,3839,311
NEVP,"11/27/2022 4 p.m. PST",3653,3578,3448,-205
NEVP,"11/27/2022 5 p.m. PST",3946,3774,3282,-664
NEVP,"11/27/2022 6 p.m. PST",4124,3967,3429,-695
NEVP,"11/27/2022 7 p.m. PST",4106,4002,3433,-673
NEVP,"11/27/2022 8 p.m. PST",4093,3946,3460,-633
NEVP,"11/27/2022 9 p.m. PST",4017,3902,3439,-578
NEVP,"11/27/2022 10 p.m. PST",3908,3824,3329,-579
NEVP,"11/27/2022 11 p.m. PST",3764,3664,3311,-453
NEVP,"11/28/2022 12 a.m. PST",3636,3517,3357,-279
NEVP,"11/28/2022 1 a.m. PST",3537,3394,3286,-251
NEVP,"11/28/2022 2 a.m. PST",3487,3382,3312,-175
NEVP,"11/28/2022 3 a.m. PST",3466,3370,3491,25
NEVP,"11/28/2022 4 a.m. PST",3485,3407,3403,-82
NEVP,"11/28/2022 5 a.m. PST",3569,3512,3402,-167
NEVP,"11/28/2022 6 a.m. PST",3754,3669,3323,-431
NEVP,"11/28/2022 7 a.m. PST",3953,3877,3402,-551
NEVP,"11/28/2022 8 a.m. PST",3980,3873,3316,-664
NEVP,"11/28/2022 9 a.m. PST",3985,3827,2787,-1198
NEVP,"11/28/2022 10 a.m. PST",4021,3793,3121,-900
NEVP,"11/28/2022 11 a.m. PST",3850,3697,3542,-308
NEVP,"11/28/2022 12 p.m. PST",3745,3621,3702,-43
NEVP,"11/28/2022 1 p.m. PST",3760,3632,3712,-48
NEVP,"11/28/2022 2 p.m. PST",3787,3640,3879,92
NEVP,"11/28/2022 3 p.m. PST",3800,3715,3857,57
NEVP,"11/28/2022 4 p.m. PST",3946,3838,3615,-331
NEVP,"11/28/2022 5 p.m. PST",4182,4018,3531,-651
NEVP,"11/28/2022 6 p.m. PST",4370,4224,3834,-536
NEVP,"11/28/2022 7 p.m. PST",4354,4234,3845,-509
NEVP,"11/28/2022 8 p.m. PST",4317,4171,3877,-440
NEVP,"11/28/2022 9 p.m. PST",4256,4123,3866,-390
NEVP,"11/28/2022 10 p.m. PST",4121,3995,3777,-344
NEVP,"11/28/2022 11 p.m. PST",3934,3852,3686,-248
NEVP,"11/29/2022 12 a.m. PST",3784,3674,3486,-298
NEVP,"11/29/2022 1 a.m. PST",3677,3488,3207,-470
NEVP,"11/29/2022 2 a.m. PST",3620,3436,3131,-489
NEVP,"11/29/2022 3 a.m. PST",3586,3446,3111,-475
NEVP,"11/29/2022 4 a.m. PST",3606,3469,3017,-589
NEVP,"11/29/2022 5 a.m. PST",3693,3524,3122,-571
NEVP,"11/29/2022 6 a.m. PST",3870,3667,3268,-602
NEVP,"11/29/2022 7 a.m. PST",4062,3867,3328,-734
NEVP,"11/29/2022 8 a.m. PST",4029,4053,3722,-307
NEVP,"11/29/2022 9 a.m. PST",3964,3858,3794,-170
NEVP,"11/29/2022 10 a.m. PST",3910,3760,3494,-416
NEVP,"11/29/2022 11 a.m. PST",3773,3647,3412,-361
NEVP,"11/29/2022 12 p.m. PST",3760,3607,3288,-472
NEVP,"11/29/2022 1 p.m. PST",3727,3544,3453,-274
NEVP,"11/29/2022 2 p.m. PST",3711,3498,3609,-102
NEVP,"11/29/2022 3 p.m. PST",3692,3640,3918,226
NEVP,"11/29/2022 4 p.m. PST",3890,3765,3417,-473
NEVP,"11/29/2022 5 p.m. PST",4203,3997,3092,-1111
NEVP,"11/29/2022 6 p.m. PST",4405,4197,3503,-902
NEVP,"11/29/2022 7 p.m. PST",4407,4282,3970,-437
NEVP,"11/29/2022 8 p.m. PST",4400,4322,4152,-248
NEVP,"11/29/2022 9 p.m. PST",4337,4257,3998,-339
NEVP,"11/29/2022 10 p.m. PST",4228,4162,3874,-354
NEVP,"11/29/2022 11 p.m. PST",4059,4029,3788,-271
NEVP,"11/30/2022 12 a.m. PST",3900,3858,3623,-277
NEVP,"11/30/2022 1 a.m. PST",3814,3504,3221,-593
NEVP,"11/30/2022 2 a.m. PST",3777,3473,3065,-712
NEVP,"11/30/2022 3 a.m. PST",3778,3430,3028,-750
NEVP,"11/30/2022 4 a.m. PST",3819,3440,2941,-878
NEVP,"11/30/2022 5 a.m. PST",3915,3522,3035,-880
NEVP,"11/30/2022 6 a.m. PST",4090,3685,3316,-774
NEVP,"11/30/2022 7 a.m. PST",4274,3847,3405,-869
NEVP,"11/30/2022 8 a.m. PST",4230,3971,3680,-550
NEVP,"11/30/2022 9 a.m. PST",4086,3830,3738,-348
NEVP,"11/30/2022 10 a.m. PST",4084,3708,3832,-252
NEVP,"11/30/2022 11 a.m. PST",3901,3578,3756,-145
NEVP,"11/30/2022 12 p.m. PST",3804,3514,3745,-59
NEVP,"11/30/2022 1 p.m. PST",3765,3503,3703,-62
NEVP,"11/30/2022 2 p.m. PST",3737,3554,3876,139
NEVP,"11/30/2022 3 p.m. PST",3775,3676,3949,174
NEVP,"11/30/2022 4 p.m. PST",3909,3782,3277,-632
NEVP,"11/30/2022 5 p.m. PST",4111,4026,3336,-775
NEVP,"11/30/2022 6 p.m. PST",4354,4217,3602,-752
NEVP,"11/30/2022 7 p.m. PST",4360,4219,3708,-652
NEVP,"11/30/2022 8 p.m. PST",4331,4214,3870,-461
NEVP,"11/30/2022 9 p.m. PST",4262,4175,3929,-333
NEVP,"11/30/2022 10 p.m. PST",4134,4057,3755,-379
NEVP,"11/30/2022 11 p.m. PST",3960,3868,3727,-233
NEVP,"12/1/2022 12 a.m. PST",3825,3703,3290,-535
