"BA Code","Timestamp (Hour Ending)","Demand (MWh)","Demand Forecast (MWh)","Net Generation (MWh)","Total Interchange (MWh)"
NEVP,"12/1/2021 12 a.m. PST",3447,3446,3151,-296
NEVP,"12/1/2021 1 a.m. PST",3331,3377,2795,-536
NEVP,"12/1/2021 2 a.m. PST",3274,3308,2818,-456
NEVP,"12/1/2021 3 a.m. PST",3239,3286,2904,-335
NEVP,"12/1/2021 4 a.m. PST",3248,3309,2889,-359
NEVP,"12/1/2021 5 a.m. PST",3322,3352,3011,-311
NEVP,"12/1/2021 6 a.m. PST",3498,3455,3075,-423
NEVP,"12/1/2021 7 a.m. PST",3689,3685,3256,-433
NEVP,"12/1/2021 8 a.m. PST",3691,3617,3154,-537
NEVP,"12/1/2021 9 a.m. PST",3615,3573,3262,-353
NEVP,"12/1/2021 10 a.m. PST",3543,3526,3173,-370
NEVP,"12/1/2021 11 a.m. PST",3562,3498,3144,-418
NEVP,"12/1/2021 12 p.m. PST",3575,3484,3230,-345
NEVP,"12/1/2021 1 p.m. PST",3604,3491,3218,-386
NEVP,"12/1/2021 2 p.m. PST",3680,3560,3324,-356
NEVP,"12/1/2021 3 p.m. PST",3729,3618,3387,-342
NEVP,"12/1/2021 4 p.m. PST",3830,3746,3282,-548
NEVP,"12/1/2021 5 p.m. PST",4022,3891,3539,-483
NEVP,"12/1/2021 6 p.m. PST",4157,4010,3934,-223
NEVP,"12/1/2021 7 p.m. PST",4114,3990,3945,-169
NEVP,"12/1/2021 8 p.m. PST",4050,3918,3756,-294
NEVP,"12/1/2021 9 p.m. PST",3976,3865,3384,-592
NEVP,"12/1/2021 10 p.m. PST",3820,3750,3099,-721
NEVP,"12/1/2021 11 p.m. PST",3649,3605,2918,-731
NEVP,"12/2/2021 12 a.m. PST",3469,3470,2973,-496
NEVP,"12/2/2021 1 a.m. PST",3350,3353,2819,-531
NEVP,"12/2/2021 2 a.m. PST",3283,3312,2709,-574
NEVP,"12/2/2021 3 a.m. PST",3260,3267,2642,-618
NEVP,"12/2/2021 4 a.m. PST",3270,3280,2562,-708
NEVP,"12/2/2021 5 a.m. PST",3342,3313,2750,-592
NEVP,"12/2/2021 6 a.m. PST",3515,3453,3058,-457
NEVP,"12/2/2021 7 a.m. PST",3714,3567,3195,-519
NEVP,"12/2/2021 8 a.m. PST",3738,3652,3266,-472
NEVP,"12/2/2021 9 a.m. PST",3684,3611,3158,-526
NEVP,"12/2/2021 10 a.m. PST",3605,3555,2842,-763
NEVP,"12/2/2021 11 a.m. PST",3564,3517,2618,-946
NEVP,"12/2/2021 12 p.m. PST",3618,3525,2608,-1010
NEVP,"12/2/2021 1 p.m. PST",3655,3561,2857,-798
NEVP,"12/2/2021 2 p.m. PST",3634,3618,2884,-750
NEVP,"12/2/2021 3 p.m. PST",3679,3694,3027,-652
NEVP,"12/2/2021 4 p.m. PST",3765,3781,3085,-680
NEVP,"12/2/2021 5 p.m. PST",3968,3954,3410,-558
NEVP,"12/2/2021 6 p.m. PST",4126,4160,3590,-536
NEVP,"12/2/2021 7 p.m. PST",4091,4133,3609,-482
NEVP,"12/2/2021 8 p.m. PST",4076,4040,3601,-475
NEVP,"12/2/2021 9 p.m. PST",4035,3937,3406,-629
NEVP,"12/2/2021 10 p.m. PST",3849,3803,3221,-628
NEVP,"12/2/2021 11 p.m. PST",3654,3625,3205,-449
NEVP,"12/3/2021 12 a.m. PST",3494,3461,3160,-334
NEVP,"12/3/2021 1 a.m. PST",3371,3383,3181,-190
NEVP,"12/3/2021 2 a.m. PST",3292,3325,3203,-89
NEVP,"12/3/2021 3 a.m. PST",3273,3289,3226,-47
NEVP,"12/3/2021 4 a.m. PST",3272,3308,3196,-76
NEVP,"12/3/2021 5 a.m. PST",3337,3366,3232,-105
NEVP,"12/3/2021 6 a.m. PST",3499,3544,3251,-248
NEVP,"12/3/2021 7 a.m. PST",3693,3676,3334,-359
NEVP,"12/3/2021 8 a.m. PST",3711,3675,3353,-358
NEVP,"12/3/2021 9 a.m. PST",3691,3566,3404,-287
NEVP,"12/3/2021 10 a.m. PST",3656,3471,3352,-304
NEVP,"12/3/2021 11 a.m. PST",3633,3525,3356,-277
NEVP,"12/3/2021 12 p.m. PST",3628,3527,3543,-85
NEVP,"12/3/2021 1 p.m. PST",3639,3513,3304,-335
NEVP,"12/3/2021 2 p.m. PST",3663,3537,3473,-190
NEVP,"12/3/2021 3 p.m. PST",3739,3601,3426,-313
NEVP,"12/3/2021 4 p.m. PST",3929,3725,3501,-428
NEVP,"12/3/2021 5 p.m. PST",4159,3874,3928,-231
NEVP,"12/3/2021 6 p.m. PST",4268,4005,3974,-294
NEVP,"12/3/2021 7 p.m. PST",4193,3988,3857,-336
NEVP,"12/3/2021 8 p.m. PST",4157,3911,3745,-412
NEVP,"12/3/2021 9 p.m. PST",4091,3852,3713,-378
NEVP,"12/3/2021 10 p.m. PST",3930,3770,3540,-390
NEVP,"12/3/2021 11 p.m. PST",3788,3634,3471,-317
NEVP,"12/4/2021 12 a.m. PST",3646,3492,3223,-423
NEVP,"12/4/2021 1 a.m. PST",3590,3430,3155,-435
NEVP,"12/4/2021 2 a.m. PST",3523,3367,3051,-472
NEVP,"12/4/2021 3 a.m. PST",3427,3332,2977,-450
NEVP,"12/4/2021 4 a.m. PST",3414,3337,2945,-469
NEVP,"12/4/2021 5 a.m. PST",3446,3346,2978,-468
NEVP,"12/4/2021 6 a.m. PST",3526,3416,3144,-382
NEVP,"12/4/2021 7 a.m. PST",3619,3469,3241,-378
NEVP,"12/4/2021 8 a.m. PST",3599,3544,3456,-143
NEVP,"12/4/2021 9 a.m. PST",3562,3521,3308,-254
NEVP,"12/4/2021 10 a.m. PST",3557,3504,3197,-360
NEVP,"12/4/2021 11 a.m. PST",3559,3466,2945,-614
NEVP,"12/4/2021 12 p.m. PST",3542,3470,3006,-536
NEVP,"12/4/2021 1 p.m. PST",3539,3490,3116,-423
NEVP,"12/4/2021 2 p.m. PST",3491,3542,3171,-320
NEVP,"12/4/2021 3 p.m. PST",3549,3641,3244,-305
NEVP,"12/4/2021 4 p.m. PST",3719,3734,3262,-457
NEVP,"12/4/2021 5 p.m. PST",3961,3923,3747,-214
NEVP,"12/4/2021 6 p.m. PST",4125,4058,3963,-162
NEVP,"12/4/2021 7 p.m. PST",4078,3998,3790,-288
NEVP,"12/4/2021 8 p.m. PST",4064,3954,3596,-468
NEVP,"12/4/2021 9 p.m. PST",3975,3893,3396,-579
NEVP,"12/4/2021 10 p.m. PST",3898,3778,3348,-550
NEVP,"12/4/2021 11 p.m. PST",3768,3628,3166,-602
NEVP,"12/5/2021 12 a.m. PST",3648,3469,3020,-628
NEVP,"12/5/2021 1 a.m. PST",3545,3407,2870,-675
NEVP,"12/5/2021 2 a.m. PST",3471,3341,2703,-768
NEVP,"12/5/2021 3 a.m. PST",3422,3313,2656,-766
NEVP,"12/5/2021 4 a.m. PST",3404,3320,2739,-665
NEVP,"12/5/2021 5 a.m. PST",3423,3362,2980,-443
NEVP,"12/5/2021 6 a.m. PST",3494,3468,3072,-422
NEVP,"12/5/2021 7 a.m. PST",3567,3571,3302,-265
NEVP,"12/5/2021 8 a.m. PST",3454,3520,3227,-227
NEVP,"12/5/2021 9 a.m. PST",3434,3497,3115,-319
NEVP,"12/5/2021 10 a.m. PST",3441,3480,3178,-263
NEVP,"12/5/2021 11 a.m. PST",3455,3443,3230,-225
NEVP,"12/5/2021 12 p.m. PST",3464,3447,3097,-367
NEVP,"12/5/2021 1 p.m. PST",3470,3467,3052,-418
NEVP,"12/5/2021 2 p.m. PST",3504,3519,3195,-309
NEVP,"12/5/2021 3 p.m. PST",3560,3598,3280,-280
NEVP,"12/5/2021 4 p.m. PST",3722,3682,3310,-412
NEVP,"12/5/2021 5 p.m. PST",3996,3869,3474,-522
NEVP,"12/5/2021 6 p.m. PST",4182,4061,3712,-470
NEVP,"12/5/2021 7 p.m. PST",4146,4015,3655,-491
NEVP,"12/5/2021 8 p.m. PST",4087,3959,3641,-446
NEVP,"12/5/2021 9 p.m. PST",4013,3895,3642,-371
NEVP,"12/5/2021 10 p.m. PST",3887,3802,3588,-299
NEVP,"12/5/2021 11 p.m. PST",3724,3673,3447,-277
NEVP,"12/6/2021 12 a.m. PST",3574,3506,3469,-105
NEVP,"12/6/2021 1 a.m. PST",3444,3415,3441,-3
NEVP,"12/6/2021 2 a.m. PST",3396,3351,3362,-34
NEVP,"12/6/2021 3 a.m. PST",3370,3332,3320,-50
NEVP,"12/6/2021 4 a.m. PST",3381,3327,3345,-36
NEVP,"12/6/2021 5 a.m. PST",3440,3393,3365,-75
NEVP,"12/6/2021 6 a.m. PST",3630,3549,3505,-125
NEVP,"12/6/2021 7 a.m. PST",3820,3761,3643,-177
NEVP,"12/6/2021 8 a.m. PST",3840,3729,3647,-193
NEVP,"12/6/2021 9 a.m. PST",3749,3700,3761,12
NEVP,"12/6/2021 10 a.m. PST",3745,3668,3887,142
NEVP,"12/6/2021 11 a.m. PST",3749,3610,3709,-40
NEVP,"12/6/2021 12 p.m. PST",3746,3603,3788,42
NEVP,"12/6/2021 1 p.m. PST",3794,3591,3731,-63
NEVP,"12/6/2021 2 p.m. PST",3861,3651,3760,-101
NEVP,"12/6/2021 3 p.m. PST",3946,3748,3776,-170
NEVP,"12/6/2021 4 p.m. PST",4042,3847,3659,-383
NEVP,"12/6/2021 5 p.m. PST",4243,3986,4059,-184
NEVP,"12/6/2021 6 p.m. PST",4378,4085,4200,-178
NEVP,"12/6/2021 7 p.m. PST",4327,4034,3986,-341
NEVP,"12/6/2021 8 p.m. PST",4268,3980,3861,-407
NEVP,"12/6/2021 9 p.m. PST",4168,3919,3825,-343
NEVP,"12/6/2021 10 p.m. PST",4009,3802,3577,-432
NEVP,"12/6/2021 11 p.m. PST",3796,3673,3333,-463
NEVP,"12/7/2021 12 a.m. PST",3609,3524,3374,-235
NEVP,"12/7/2021 1 a.m. PST",3472,3426,3332,-140
NEVP,"12/7/2021 2 a.m. PST",3389,3354,3244,-145
NEVP,"12/7/2021 3 a.m. PST",3349,3338,3200,-149
NEVP,"12/7/2021 4 a.m. PST",3355,3328,3083,-272
NEVP,"12/7/2021 5 a.m. PST",3412,3411,3299,-113
NEVP,"12/7/2021 6 a.m. PST",3576,3576,3290,-286
NEVP,"12/7/2021 7 a.m. PST",3793,3796,3376,-417
NEVP,"12/7/2021 8 a.m. PST",3866,3827,3394,-472
NEVP,"12/7/2021 9 a.m. PST",3911,3830,3520,-391
NEVP,"12/7/2021 10 a.m. PST",3941,3822,3650,-291
NEVP,"12/7/2021 11 a.m. PST",3891,3804,3685,-206
NEVP,"12/7/2021 12 p.m. PST",3923,3793,3730,-193
NEVP,"12/7/2021 1 p.m. PST",3993,3797,3576,-417
NEVP,"12/7/2021 2 p.m. PST",3949,3786,3398,-551
NEVP,"12/7/2021 3 p.m. PST",3950,3786,3529,-421
NEVP,"12/7/2021 4 p.m. PST",3977,3848,3662,-315
NEVP,"12/7/2021 5 p.m. PST",4144,4116,3979,-165
NEVP,"12/7/2021 6 p.m. PST",4313,4328,4071,-242
NEVP,"12/7/2021 7 p.m. PST",4316,4286,3919,-397
NEVP,"12/7/2021 8 p.m. PST",4263,4222,3778,-485
NEVP,"12/7/2021 9 p.m. PST",4176,4144,3602,-574
NEVP,"12/7/2021 10 p.m. PST",4028,3993,3587,-441
NEVP,"12/7/2021 11 p.m. PST",3715,3857,3279,-436
NEVP,"12/8/2021 12 a.m. PST",3543,3704,3063,-480
NEVP,"12/8/2021 1 a.m. PST",3414,3449,2982,-432
NEVP,"12/8/2021 2 a.m. PST",3346,3368,2612,-734
NEVP,"12/8/2021 3 a.m. PST",3301,3326,2945,-356
NEVP,"12/8/2021 4 a.m. PST",3309,3342,3041,-268
NEVP,"12/8/2021 5 a.m. PST",3383,3403,3192,-191
NEVP,"12/8/2021 6 a.m. PST",3544,3600,3381,-163
NEVP,"12/8/2021 7 a.m. PST",3741,3746,3340,-401
NEVP,"12/8/2021 8 a.m. PST",3822,3839,3499,-323
NEVP,"12/8/2021 9 a.m. PST",3640,3800,2927,-713
NEVP,"12/8/2021 10 a.m. PST",3582,3724,3113,-469
NEVP,"12/8/2021 11 a.m. PST",3561,3693,3194,-367
NEVP,"12/8/2021 12 p.m. PST",3543,3680,3030,-513
NEVP,"12/8/2021 1 p.m. PST",3531,3697,2991,-540
NEVP,"12/8/2021 2 p.m. PST",3548,3732,3053,-495
NEVP,"12/8/2021 3 p.m. PST",3596,3809,3089,-507
NEVP,"12/8/2021 4 p.m. PST",3764,3906,3111,-653
NEVP,"12/8/2021 5 p.m. PST",4046,4109,3497,-549
NEVP,"12/8/2021 6 p.m. PST",4205,4282,3749,-456
NEVP,"12/8/2021 7 p.m. PST",4169,4262,3717,-452
NEVP,"12/8/2021 8 p.m. PST",4118,4216,3521,-597
NEVP,"12/8/2021 9 p.m. PST",4049,4120,3431,-618
NEVP,"12/8/2021 10 p.m. PST",3914,3974,3265,-649
NEVP,"12/8/2021 11 p.m. PST",3719,3825,2876,-843
NEVP,"12/9/2021 12 a.m. PST",3533,3655,2652,-881
NEVP,"12/9/2021 1 a.m. PST",3425,3511,2664,-761
NEVP,"12/9/2021 2 a.m. PST",3359,3443,3071,-288
NEVP,"12/9/2021 3 a.m. PST",3340,3425,3239,-101
NEVP,"12/9/2021 4 a.m. PST",3355,3446,3303,-52
NEVP,"12/9/2021 5 a.m. PST",3422,3516,3334,-88
NEVP,"12/9/2021 6 a.m. PST",3589,3695,3423,-166
NEVP,"12/9/2021 7 a.m. PST",3810,3894,3375,-435
NEVP,"12/9/2021 8 a.m. PST",3916,3889,3523,-393
NEVP,"12/9/2021 9 a.m. PST",3984,3935,3452,-532
NEVP,"12/9/2021 10 a.m. PST",3970,3999,3323,-647
NEVP,"12/9/2021 11 a.m. PST",4073,4003,3574,-499
NEVP,"12/9/2021 12 p.m. PST",4047,3984,3458,-589
NEVP,"12/9/2021 1 p.m. PST",4002,4058,3547,-455
NEVP,"12/9/2021 2 p.m. PST",3948,4025,3471,-477
NEVP,"12/9/2021 3 p.m. PST",3940,3969,3523,-417
NEVP,"12/9/2021 4 p.m. PST",4028,4045,3638,-390
NEVP,"12/9/2021 5 p.m. PST",4180,4273,3622,-558
NEVP,"12/9/2021 6 p.m. PST",4373,4363,3713,-660
NEVP,"12/9/2021 7 p.m. PST",4356,4362,3708,-648
NEVP,"12/9/2021 8 p.m. PST",4312,4263,3633,-679
NEVP,"12/9/2021 9 p.m. PST",4236,4179,3556,-680
NEVP,"12/9/2021 10 p.m. PST",4096,4051,3558,-538
NEVP,"12/9/2021 11 p.m. PST",3899,3884,3475,-424
NEVP,"12/10/2021 12 a.m. PST",3738,3732,3488,-250
NEVP,"12/10/2021 1 a.m. PST",3603,3490,3526,-77
NEVP,"12/10/2021 2 a.m. PST",3538,3431,3510,-28
NEVP,"12/10/2021 3 a.m. PST",3477,3417,3435,-42
NEVP,"12/10/2021 4 a.m. PST",3519,3429,3376,-143
NEVP,"12/10/2021 5 a.m. PST",3595,3498,3351,-244
NEVP,"12/10/2021 6 a.m. PST",3767,3688,3514,-253
NEVP,"12/10/2021 7 a.m. PST",3975,3877,3599,-376
NEVP,"12/10/2021 8 a.m. PST",3947,4013,3828,-119
NEVP,"12/10/2021 9 a.m. PST",3915,3924,3641,-274
NEVP,"12/10/2021 10 a.m. PST",3827,3855,3505,-322
NEVP,"12/10/2021 11 a.m. PST",3725,3818,3641,-84
NEVP,"12/10/2021 12 p.m. PST",3660,3793,3637,-23
NEVP,"12/10/2021 1 p.m. PST",3614,3759,3477,-137
NEVP,"12/10/2021 2 p.m. PST",3637,3755,3517,-120
NEVP,"12/10/2021 3 p.m. PST",3696,3786,3453,-243
NEVP,"12/10/2021 4 p.m. PST",3849,3936,3468,-381
NEVP,"12/10/2021 5 p.m. PST",4190,4178,3646,-544
NEVP,"12/10/2021 6 p.m. PST",4392,4355,3815,-577
NEVP,"12/10/2021 7 p.m. PST",4373,4370,3882,-491
NEVP,"12/10/2021 8 p.m. PST",4334,4408,3719,-615
NEVP,"12/10/2021 9 p.m. PST",4297,4289,3714,-583
NEVP,"12/10/2021 10 p.m. PST",4195,4264,3731,-464
NEVP,"12/10/2021 11 p.m. PST",4075,4052,3476,-599
NEVP,"12/11/2021 12 a.m. PST",3960,3912,3582,-378
NEVP,"12/11/2021 1 a.m. PST",3848,3832,3497,-351
NEVP,"12/11/2021 2 a.m. PST",3774,3769,3322,-452
NEVP,"12/11/2021 3 a.m. PST",3737,3761,3292,-445
NEVP,"12/11/2021 4 a.m. PST",3747,3791,3292,-455
NEVP,"12/11/2021 5 a.m. PST",3783,3805,3378,-405
NEVP,"12/11/2021 6 a.m. PST",3880,3861,3461,-419
NEVP,"12/11/2021 7 a.m. PST",3977,3924,3593,-384
NEVP,"12/11/2021 8 a.m. PST",3990,3848,3592,-398
NEVP,"12/11/2021 9 a.m. PST",3965,3843,3166,-799
NEVP,"12/11/2021 10 a.m. PST",3921,3871,3205,-716
NEVP,"12/11/2021 11 a.m. PST",3807,3853,3077,-730
NEVP,"12/11/2021 12 p.m. PST",3749,3788,2919,-830
NEVP,"12/11/2021 1 p.m. PST",3696,3749,2885,-811
NEVP,"12/11/2021 2 p.m. PST",3699,3707,2912,-787
NEVP,"12/11/2021 3 p.m. PST",3737,3731,2982,-755
NEVP,"12/11/2021 4 p.m. PST",3885,3796,3208,-677
NEVP,"12/11/2021 5 p.m. PST",4148,4009,3901,-247
NEVP,"12/11/2021 6 p.m. PST",4368,4225,4180,-188
NEVP,"12/11/2021 7 p.m. PST",4353,4225,4010,-343
NEVP,"12/11/2021 8 p.m. PST",4324,4234,3888,-436
NEVP,"12/11/2021 9 p.m. PST",4281,4195,3783,-498
NEVP,"12/11/2021 10 p.m. PST",4215,4113,3744,-471
NEVP,"12/11/2021 11 p.m. PST",4095,3954,3599,-496
NEVP,"12/12/2021 12 a.m. PST",3960,3840,3599,-361
NEVP,"12/12/2021 1 a.m. PST",3858,3797,3595,-263
NEVP,"12/12/2021 2 a.m. PST",3781,3720,3536,-245
NEVP,"12/12/2021 3 a.m. PST",3743,3676,3566,-177
NEVP,"12/12/2021 4 a.m. PST",3746,3638,3360,-386
NEVP,"12/12/2021 5 a.m. PST",3761,3632,3388,-373
NEVP,"12/12/2021 6 a.m. PST",3833,3662,3412,-421
NEVP,"12/12/2021 7 a.m. PST",3908,3746,3141,-767
NEVP,"12/12/2021 8 a.m. PST",3865,3736,3128,-737
NEVP,"12/12/2021 9 a.m. PST",3790,3720,3267,-523
NEVP,"12/12/2021 10 a.m. PST",3722,3681,3319,-403
NEVP,"12/12/2021 11 a.m. PST",3674,3689,3216,-458
NEVP,"12/12/2021 12 p.m. PST",3617,3639,3090,-527
NEVP,"12/12/2021 1 p.m. PST",3617,3648,3157,-460
NEVP,"12/12/2021 2 p.m. PST",3611,3571,3282,-329
NEVP,"12/12/2021 3 p.m. PST",3661,3637,3402,-259
NEVP,"12/12/2021 4 p.m. PST",3779,3781,3319,-460
NEVP,"12/12/2021 5 p.m. PST",4072,4024,3769,-303
NEVP,"12/12/2021 6 p.m. PST",4296,4271,3956,-340
NEVP,"12/12/2021 7 p.m. PST",4289,4281,3782,-507
NEVP,"12/12/2021 8 p.m. PST",4259,4279,3692,-567
NEVP,"12/12/2021 9 p.m. PST",4209,4234,3555,-654
NEVP,"12/12/2021 10 p.m. PST",4103,4137,3546,-557
NEVP,"12/12/2021 11 p.m. PST",3954,3965,3522,-432
NEVP,"12/13/2021 12 a.m. PST",3793,3819,3321,-472
NEVP,"12/13/2021 1 a.m. PST",3698,3674,3314,-384
NEVP,"12/13/2021 2 a.m. PST",3624,3602,3359,-265
NEVP,"12/13/2021 3 a.m. PST",3610,3580,3341,-269
NEVP,"12/13/2021 4 a.m. PST",3618,3622,3182,-436
NEVP,"12/13/2021 5 a.m. PST",3724,3673,3152,-572
NEVP,"12/13/2021 6 a.m. PST",3931,3832,3226,-705
NEVP,"12/13/2021 7 a.m. PST",4149,4044,3249,-900
NEVP,"12/13/2021 8 a.m. PST",4204,4105,3543,-661
NEVP,"12/13/2021 9 a.m. PST",3992,4062,3459,-533
NEVP,"12/13/2021 10 a.m. PST",3972,4014,3778,-194
NEVP,"12/13/2021 11 a.m. PST",3932,3967,3693,-239
NEVP,"12/13/2021 12 p.m. PST",3864,3937,3539,-325
NEVP,"12/13/2021 1 p.m. PST",3842,3949,3703,-139
NEVP,"12/13/2021 2 p.m. PST",3893,3848,3660,-233
NEVP,"12/13/2021 3 p.m. PST",3959,3887,3489,-470
NEVP,"12/13/2021 4 p.m. PST",4066,3977,3477,-589
NEVP,"12/13/2021 5 p.m. PST",4324,4155,3737,-587
NEVP,"12/13/2021 6 p.m. PST",4463,4394,4036,-427
NEVP,"12/13/2021 7 p.m. PST",4433,4424,3955,-478
NEVP,"12/13/2021 8 p.m. PST",4355,4341,3781,-574
NEVP,"12/13/2021 9 p.m. PST",4244,4293,3513,-731
NEVP,"12/13/2021 10 p.m. PST",4089,4135,3465,-624
NEVP,"12/13/2021 11 p.m. PST",3872,3946,3133,-739
NEVP,"12/14/2021 12 a.m. PST",3708,3809,2860,-848
NEVP,"12/14/2021 1 a.m. PST",3608,3688,2759,-849
NEVP,"12/14/2021 2 a.m. PST",3520,3555,3120,-400
NEVP,"12/14/2021 3 a.m. PST",3489,3498,2913,-576
NEVP,"12/14/2021 4 a.m. PST",3511,3500,3161,-350
NEVP,"12/14/2021 5 a.m. PST",3572,3570,3211,-361
NEVP,"12/14/2021 6 a.m. PST",3734,3768,3450,-284
NEVP,"12/14/2021 7 a.m. PST",3954,3957,3699,-255
NEVP,"12/14/2021 8 a.m. PST",3967,4094,3569,-398
NEVP,"12/14/2021 9 a.m. PST",4023,4099,3860,-163
NEVP,"12/14/2021 10 a.m. PST",4008,4100,3723,-285
NEVP,"12/14/2021 11 a.m. PST",4019,4128,3806,-213
NEVP,"12/14/2021 12 p.m. PST",4033,4105,3478,-555
NEVP,"12/14/2021 1 p.m. PST",4033,4064,3442,-591
NEVP,"12/14/2021 2 p.m. PST",4054,4077,3335,-719
NEVP,"12/14/2021 3 p.m. PST",4060,4083,3405,-655
NEVP,"12/14/2021 4 p.m. PST",4173,4165,3590,-583
NEVP,"12/14/2021 5 p.m. PST",4396,4305,3867,-529
NEVP,"12/14/2021 6 p.m. PST",4479,4511,3949,-530
NEVP,"12/14/2021 7 p.m. PST",4478,4564,3809,-669
NEVP,"12/14/2021 8 p.m. PST",4463,4499,3746,-717
NEVP,"12/14/2021 9 p.m. PST",4383,4404,3448,-935
NEVP,"12/14/2021 10 p.m. PST",4236,4269,3621,-615
NEVP,"12/14/2021 11 p.m. PST",4038,4074,3390,-648
NEVP,"12/15/2021 12 a.m. PST",3879,3910,3100,-779
NEVP,"12/15/2021 1 a.m. PST",3755,3758,3037,-718
NEVP,"12/15/2021 2 a.m. PST",3693,3670,3061,-632
NEVP,"12/15/2021 3 a.m. PST",3677,3614,2957,-720
NEVP,"12/15/2021 4 a.m. PST",3707,3616,3293,-414
NEVP,"12/15/2021 5 a.m. PST",3802,3685,3392,-410
NEVP,"12/15/2021 6 a.m. PST",3964,3883,3515,-449
NEVP,"12/15/2021 7 a.m. PST",4163,4090,3570,-593
NEVP,"12/15/2021 8 a.m. PST",4164,4211,3722,-442
NEVP,"12/15/2021 9 a.m. PST",4061,4153,3866,-195
NEVP,"12/15/2021 10 a.m. PST",4001,4098,3569,-432
NEVP,"12/15/2021 11 a.m. PST",3997,3993,3180,-817
NEVP,"12/15/2021 12 p.m. PST",3912,3883,3374,-538
NEVP,"12/15/2021 1 p.m. PST",3874,3856,3488,-386
NEVP,"12/15/2021 2 p.m. PST",3829,3852,3490,-339
NEVP,"12/15/2021 3 p.m. PST",3882,3940,3379,-503
NEVP,"12/15/2021 4 p.m. PST",4011,4015,3344,-667
NEVP,"12/15/2021 5 p.m. PST",4376,4300,3820,-556
NEVP,"12/15/2021 6 p.m. PST",4543,4483,4017,-526
NEVP,"12/15/2021 7 p.m. PST",4555,4504,4002,-553
NEVP,"12/15/2021 8 p.m. PST",4534,4477,4032,-502
NEVP,"12/15/2021 9 p.m. PST",4473,4421,3984,-489
NEVP,"12/15/2021 10 p.m. PST",4364,4286,3921,-443
NEVP,"12/15/2021 11 p.m. PST",4193,4095,3846,-347
NEVP,"12/16/2021 12 a.m. PST",4021,3915,3731,-290
NEVP,"12/16/2021 1 a.m. PST",3931,3858,3597,-334
NEVP,"12/16/2021 2 a.m. PST",3861,3801,3513,-348
NEVP,"12/16/2021 3 a.m. PST",3829,3772,3723,-106
NEVP,"12/16/2021 4 a.m. PST",3835,3777,3707,-128
NEVP,"12/16/2021 5 a.m. PST",3912,3851,3772,-140
NEVP,"12/16/2021 6 a.m. PST",4082,4057,3719,-363
NEVP,"12/16/2021 7 a.m. PST",4284,4280,3780,-504
NEVP,"12/16/2021 8 a.m. PST",4293,4345,3922,-371
NEVP,"12/16/2021 9 a.m. PST",4202,4274,3991,-211
NEVP,"12/16/2021 10 a.m. PST",4084,4192,3823,-261
NEVP,"12/16/2021 11 a.m. PST",3955,4144,3837,-118
NEVP,"12/16/2021 12 p.m. PST",3862,4090,3549,-313
NEVP,"12/16/2021 1 p.m. PST",3879,4069,3558,-321
NEVP,"12/16/2021 2 p.m. PST",3907,4075,3643,-264
NEVP,"12/16/2021 3 p.m. PST",3892,4056,3792,-100
NEVP,"12/16/2021 4 p.m. PST",4064,4184,3342,-722
NEVP,"12/16/2021 5 p.m. PST",4353,4456,3550,-803
NEVP,"12/16/2021 6 p.m. PST",4544,4645,4053,-491
NEVP,"12/16/2021 7 p.m. PST",4531,4649,4116,-415
NEVP,"12/16/2021 8 p.m. PST",4507,4563,4018,-489
NEVP,"12/16/2021 9 p.m. PST",4457,4541,3791,-666
NEVP,"12/16/2021 10 p.m. PST",4343,4407,3578,-765
NEVP,"12/16/2021 11 p.m. PST",4168,4198,3478,-690
NEVP,"12/17/2021 12 a.m. PST",4007,4075,3379,-628
NEVP,"12/17/2021 1 a.m. PST",3897,3986,3318,-579
NEVP,"12/17/2021 2 a.m. PST",3834,3907,3333,-501
NEVP,"12/17/2021 3 a.m. PST",3806,3929,3319,-487
NEVP,"12/17/2021 4 a.m. PST",3826,3930,3360,-466
NEVP,"12/17/2021 5 a.m. PST",3913,4005,3407,-506
NEVP,"12/17/2021 6 a.m. PST",4092,4175,3578,-514
NEVP,"12/17/2021 7 a.m. PST",4296,4357,3705,-591
NEVP,"12/17/2021 8 a.m. PST",4300,4325,3919,-381
NEVP,"12/17/2021 9 a.m. PST",4188,4276,4041,-147
NEVP,"12/17/2021 10 a.m. PST",4067,4100,3931,-136
NEVP,"12/17/2021 11 a.m. PST",3930,3988,3766,-164
NEVP,"12/17/2021 12 p.m. PST",3893,3870,3452,-441
NEVP,"12/17/2021 1 p.m. PST",3745,3826,3234,-511
NEVP,"12/17/2021 2 p.m. PST",3781,3810,3357,-424
NEVP,"12/17/2021 3 p.m. PST",3874,3854,3572,-302
NEVP,"12/17/2021 4 p.m. PST",3978,4008,3603,-375
NEVP,"12/17/2021 5 p.m. PST",4275,4326,3772,-503
NEVP,"12/17/2021 6 p.m. PST",4492,4478,4089,-403
NEVP,"12/17/2021 7 p.m. PST",4497,4585,4056,-441
NEVP,"12/17/2021 8 p.m. PST",4478,4426,3876,-602
NEVP,"12/17/2021 9 p.m. PST",4442,4388,3937,-505
NEVP,"12/17/2021 10 p.m. PST",4334,4310,3764,-570
NEVP,"12/17/2021 11 p.m. PST",4237,4198,3576,-661
NEVP,"12/18/2021 12 a.m. PST",4084,4101,3507,-577
NEVP,"12/18/2021 1 a.m. PST",3993,3904,3491,-502
NEVP,"12/18/2021 2 a.m. PST",3900,3834,3447,-453
NEVP,"12/18/2021 3 a.m. PST",3875,3794,3459,-416
NEVP,"12/18/2021 4 a.m. PST",3882,3793,3361,-521
NEVP,"12/18/2021 5 a.m. PST",3939,3793,3308,-631
NEVP,"12/18/2021 6 a.m. PST",4031,3859,3404,-627
NEVP,"12/18/2021 7 a.m. PST",4128,4002,3340,-788
NEVP,"12/18/2021 8 a.m. PST",4077,4092,3432,-645
NEVP,"12/18/2021 9 a.m. PST",3957,4048,3531,-426
NEVP,"12/18/2021 10 a.m. PST",3938,3919,3704,-234
NEVP,"12/18/2021 11 a.m. PST",3842,3824,3570,-272
NEVP,"12/18/2021 12 p.m. PST",3751,3741,3293,-458
NEVP,"12/18/2021 1 p.m. PST",3702,3709,3242,-460
NEVP,"12/18/2021 2 p.m. PST",3700,3663,3313,-387
NEVP,"12/18/2021 3 p.m. PST",3745,3708,3339,-406
NEVP,"12/18/2021 4 p.m. PST",3844,3897,3229,-615
NEVP,"12/18/2021 5 p.m. PST",4134,4195,3301,-833
NEVP,"12/18/2021 6 p.m. PST",4366,4431,3673,-693
NEVP,"12/18/2021 7 p.m. PST",4374,4417,3674,-700
NEVP,"12/18/2021 8 p.m. PST",4360,4312,3757,-603
NEVP,"12/18/2021 9 p.m. PST",4348,4245,3780,-568
NEVP,"12/18/2021 10 p.m. PST",4268,4174,3753,-515
NEVP,"12/18/2021 11 p.m. PST",4156,4095,3592,-564
NEVP,"12/19/2021 12 a.m. PST",4029,4020,3549,-480
NEVP,"12/19/2021 1 a.m. PST",3924,3791,3627,-297
NEVP,"12/19/2021 2 a.m. PST",3869,3715,3603,-266
NEVP,"12/19/2021 3 a.m. PST",3842,3713,3553,-289
NEVP,"12/19/2021 4 a.m. PST",3851,3719,3511,-340
NEVP,"12/19/2021 5 a.m. PST",3893,3754,3456,-437
NEVP,"12/19/2021 6 a.m. PST",3966,3875,3498,-468
NEVP,"12/19/2021 7 a.m. PST",4054,3948,3411,-643
NEVP,"12/19/2021 8 a.m. PST",4011,4103,3549,-462
NEVP,"12/19/2021 9 a.m. PST",3956,4059,3711,-245
NEVP,"12/19/2021 10 a.m. PST",3884,3930,3679,-205
NEVP,"12/19/2021 11 a.m. PST",3788,3835,3420,-368
NEVP,"12/19/2021 12 p.m. PST",3719,3752,3339,-380
NEVP,"12/19/2021 1 p.m. PST",3655,3720,3217,-438
NEVP,"12/19/2021 2 p.m. PST",3655,3680,3246,-409
NEVP,"12/19/2021 3 p.m. PST",3697,3704,3382,-315
NEVP,"12/19/2021 4 p.m. PST",3783,3918,3274,-509
NEVP,"12/19/2021 5 p.m. PST",4098,4277,3759,-339
NEVP,"12/19/2021 6 p.m. PST",4356,4460,3770,-586
NEVP,"12/19/2021 7 p.m. PST",4353,4417,3686,-667
NEVP,"12/19/2021 8 p.m. PST",4362,4323,3879,-483
NEVP,"12/19/2021 9 p.m. PST",4327,4256,3777,-550
NEVP,"12/19/2021 10 p.m. PST",4243,4155,3780,-463
NEVP,"12/19/2021 11 p.m. PST",4108,4025,3676,-432
NEVP,"12/20/2021 12 a.m. PST",3974,3910,3743,-231
NEVP,"12/20/2021 1 a.m. PST",3876,3954,3585,-291
NEVP,"12/20/2021 2 a.m. PST",3827,3890,3616,-211
NEVP,"12/20/2021 3 a.m. PST",3808,3863,3634,-174
NEVP,"12/20/2021 4 a.m. PST",3838,3870,3674,-164
NEVP,"12/20/2021 5 a.m. PST",3932,3949,3674,-258
NEVP,"12/20/2021 6 a.m. PST",4107,4112,3678,-429
NEVP,"12/20/2021 7 a.m. PST",4298,4312,3867,-431
NEVP,"12/20/2021 8 a.m. PST",4292,4309,4004,-288
NEVP,"12/20/2021 9 a.m. PST",4224,4154,4155,-69
NEVP,"12/20/2021 10 a.m. PST",4191,3982,4011,-180
NEVP,"12/20/2021 11 a.m. PST",4047,3852,3549,-498
NEVP,"12/20/2021 12 p.m. PST",3970,3786,3454,-516
NEVP,"12/20/2021 1 p.m. PST",3884,3767,3389,-495
NEVP,"12/20/2021 2 p.m. PST",3888,3785,3613,-275
NEVP,"12/20/2021 3 p.m. PST",3976,3832,3603,-373
NEVP,"12/20/2021 4 p.m. PST",4043,4059,3743,-300
NEVP,"12/20/2021 5 p.m. PST",4297,4351,4108,-189
NEVP,"12/20/2021 6 p.m. PST",4483,4540,4254,-229
NEVP,"12/20/2021 7 p.m. PST",4476,4526,4288,-188
NEVP,"12/20/2021 8 p.m. PST",4443,4482,4323,-120
NEVP,"12/20/2021 9 p.m. PST",4366,4419,4205,-161
NEVP,"12/20/2021 10 p.m. PST",4242,4361,4344,102
NEVP,"12/20/2021 11 p.m. PST",4062,4193,4040,-22
NEVP,"12/21/2021 12 a.m. PST",3874,4036,3745,-129
NEVP,"12/21/2021 1 a.m. PST",3753,3838,3402,-351
NEVP,"12/21/2021 2 a.m. PST",3673,3799,3427,-246
NEVP,"12/21/2021 3 a.m. PST",3628,3775,3397,-231
NEVP,"12/21/2021 4 a.m. PST",3628,3783,3376,-252
NEVP,"12/21/2021 5 a.m. PST",3694,3852,3388,-306
NEVP,"12/21/2021 6 a.m. PST",3853,4024,3583,-270
NEVP,"12/21/2021 7 a.m. PST",4031,4301,3623,-408
NEVP,"12/21/2021 8 a.m. PST",4135,4110,3769,-366
NEVP,"12/21/2021 9 a.m. PST",4191,4079,3842,-349
NEVP,"12/21/2021 10 a.m. PST",4202,3989,3718,-484
NEVP,"12/21/2021 11 a.m. PST",4221,3863,3991,-230
NEVP,"12/21/2021 12 p.m. PST",4148,3751,4108,-40
NEVP,"12/21/2021 1 p.m. PST",4068,3720,4044,-24
NEVP,"12/21/2021 2 p.m. PST",3970,3721,3816,-154
NEVP,"12/21/2021 3 p.m. PST",3940,3795,4054,114
NEVP,"12/21/2021 4 p.m. PST",4012,3858,3604,-408
NEVP,"12/21/2021 5 p.m. PST",4259,4144,3490,-769
NEVP,"12/21/2021 6 p.m. PST",4452,4341,3762,-690
NEVP,"12/21/2021 7 p.m. PST",4480,4357,3964,-516
NEVP,"12/21/2021 8 p.m. PST",4456,4351,3845,-611
NEVP,"12/21/2021 9 p.m. PST",4400,4295,3730,-670
NEVP,"12/21/2021 10 p.m. PST",4287,4166,3657,-630
NEVP,"12/21/2021 11 p.m. PST",4127,3996,3374,-753
NEVP,"12/22/2021 12 a.m. PST",3975,3845,2996,-979
NEVP,"12/22/2021 1 a.m. PST",3860,3683,2907,-953
NEVP,"12/22/2021 2 a.m. PST",3827,3615,2992,-835
NEVP,"12/22/2021 3 a.m. PST",3791,3589,3023,-768
NEVP,"12/22/2021 4 a.m. PST",3788,3592,3069,-719
NEVP,"12/22/2021 5 a.m. PST",3844,3670,3196,-648
NEVP,"12/22/2021 6 a.m. PST",3982,3829,3438,-544
NEVP,"12/22/2021 7 a.m. PST",4156,4066,3540,-616
NEVP,"12/22/2021 8 a.m. PST",4160,4046,3718,-442
NEVP,"12/22/2021 9 a.m. PST",4090,4012,3525,-565
NEVP,"12/22/2021 10 a.m. PST",4007,3964,3325,-682
NEVP,"12/22/2021 11 a.m. PST",3914,3843,3116,-798
NEVP,"12/22/2021 12 p.m. PST",3842,3772,3189,-653
NEVP,"12/22/2021 1 p.m. PST",3805,3712,3226,-579
NEVP,"12/22/2021 2 p.m. PST",3795,3715,3140,-655
NEVP,"12/22/2021 3 p.m. PST",3818,3812,3343,-475
NEVP,"12/22/2021 4 p.m. PST",3951,3859,3060,-891
NEVP,"12/22/2021 5 p.m. PST",4233,4145,3327,-906
NEVP,"12/22/2021 6 p.m. PST",4404,4357,3606,-798
NEVP,"12/22/2021 7 p.m. PST",4377,4333,3688,-689
NEVP,"12/22/2021 8 p.m. PST",4333,4307,3642,-691
NEVP,"12/22/2021 9 p.m. PST",4248,4248,3538,-710
NEVP,"12/22/2021 10 p.m. PST",4138,4108,3387,-751
NEVP,"12/22/2021 11 p.m. PST",3969,3950,3015,-954
NEVP,"12/23/2021 12 a.m. PST",3791,3754,2866,-925
NEVP,"12/23/2021 1 a.m. PST",3658,3821,3074,-584
NEVP,"12/23/2021 2 a.m. PST",3573,3762,2947,-626
NEVP,"12/23/2021 3 a.m. PST",3513,3738,3071,-442
NEVP,"12/23/2021 4 a.m. PST",3508,3736,2997,-511
NEVP,"12/23/2021 5 a.m. PST",3556,3789,3058,-498
NEVP,"12/23/2021 6 a.m. PST",3690,3846,3331,-359
NEVP,"12/23/2021 7 a.m. PST",3833,3916,3455,-378
NEVP,"12/23/2021 8 a.m. PST",3906,3957,3389,-517
NEVP,"12/23/2021 9 a.m. PST",3981,3936,3407,-574
NEVP,"12/23/2021 10 a.m. PST",3989,3890,3591,-398
NEVP,"12/23/2021 11 a.m. PST",3991,3897,3358,-633
NEVP,"12/23/2021 12 p.m. PST",3947,3876,3198,-749
NEVP,"12/23/2021 1 p.m. PST",4010,3864,3123,-887
NEVP,"12/23/2021 2 p.m. PST",4023,3863,3052,-971
NEVP,"12/23/2021 3 p.m. PST",4043,3873,3409,-634
NEVP,"12/23/2021 4 p.m. PST",4100,3953,3471,-629
NEVP,"12/23/2021 5 p.m. PST",4248,4133,3322,-926
NEVP,"12/23/2021 6 p.m. PST",4375,4338,3503,-872
NEVP,"12/23/2021 7 p.m. PST",4345,4348,3369,-976
NEVP,"12/23/2021 8 p.m. PST",4278,4310,3256,-1022
NEVP,"12/23/2021 9 p.m. PST",4185,4261,3418,-767
NEVP,"12/23/2021 10 p.m. PST",4067,4171,3383,-684
NEVP,"12/23/2021 11 p.m. PST",3922,4029,3080,-842
NEVP,"12/24/2021 12 a.m. PST",3741,3876,3302,-439
NEVP,"12/24/2021 1 a.m. PST",3602,3648,3267,-335
NEVP,"12/24/2021 2 a.m. PST",3515,3566,3285,-230
NEVP,"12/24/2021 3 a.m. PST",3443,3531,3250,-193
NEVP,"12/24/2021 4 a.m. PST",3423,3547,3260,-163
NEVP,"12/24/2021 5 a.m. PST",3448,3597,3198,-250
NEVP,"12/24/2021 6 a.m. PST",3509,3698,3123,-386
NEVP,"12/24/2021 7 a.m. PST",3596,3761,3009,-587
NEVP,"12/24/2021 8 a.m. PST",3619,3930,3179,-440
NEVP,"12/24/2021 9 a.m. PST",3689,3944,2982,-707
NEVP,"12/24/2021 10 a.m. PST",3573,3954,2787,-786
NEVP,"12/24/2021 11 a.m. PST",3527,3911,3163,-364
NEVP,"12/24/2021 12 p.m. PST",3509,3859,3002,-507
NEVP,"12/24/2021 1 p.m. PST",3502,3806,3053,-449
NEVP,"12/24/2021 2 p.m. PST",3550,3835,3314,-236
NEVP,"12/24/2021 3 p.m. PST",3649,3840,3406,-243
NEVP,"12/24/2021 4 p.m. PST",3786,3963,3691,-95
NEVP,"12/24/2021 5 p.m. PST",4021,4138,3559,-462
NEVP,"12/24/2021 6 p.m. PST",4186,4340,3891,-295
NEVP,"12/24/2021 7 p.m. PST",4141,4306,3807,-334
NEVP,"12/24/2021 8 p.m. PST",4071,4233,3693,-378
NEVP,"12/24/2021 9 p.m. PST",4016,4206,3614,-402
NEVP,"12/24/2021 10 p.m. PST",3954,4105,3575,-379
NEVP,"12/24/2021 11 p.m. PST",3847,3981,3531,-316
NEVP,"12/25/2021 12 a.m. PST",3733,3843,3403,-330
NEVP,"12/25/2021 1 a.m. PST",3633,3745,3462,-171
NEVP,"12/25/2021 2 a.m. PST",3567,3678,3473,-94
NEVP,"12/25/2021 3 a.m. PST",3521,3623,3385,-136
NEVP,"12/25/2021 4 a.m. PST",3507,3621,3266,-241
NEVP,"12/25/2021 5 a.m. PST",3530,3658,3358,-172
NEVP,"12/25/2021 6 a.m. PST",3587,3735,3402,-185
NEVP,"12/25/2021 7 a.m. PST",3667,3847,3256,-411
NEVP,"12/25/2021 8 a.m. PST",3638,3869,3041,-597
NEVP,"12/25/2021 9 a.m. PST",3564,3873,2884,-680
NEVP,"12/25/2021 10 a.m. PST",3508,3853,3094,-414
NEVP,"12/25/2021 11 a.m. PST",3453,3809,3040,-413
NEVP,"12/25/2021 12 p.m. PST",3450,3779,3085,-365
NEVP,"12/25/2021 1 p.m. PST",3452,3713,3279,-173
NEVP,"12/25/2021 2 p.m. PST",3492,3671,3577,85
NEVP,"12/25/2021 3 p.m. PST",3537,3687,3744,207
NEVP,"12/25/2021 4 p.m. PST",3652,3827,3593,-59
NEVP,"12/25/2021 5 p.m. PST",3892,4082,3380,-512
NEVP,"12/25/2021 6 p.m. PST",4051,4311,3362,-689
NEVP,"12/25/2021 7 p.m. PST",4011,4300,3440,-571
NEVP,"12/25/2021 8 p.m. PST",3979,4235,3455,-524
NEVP,"12/25/2021 9 p.m. PST",3956,4201,2937,-1019
NEVP,"12/25/2021 10 p.m. PST",3881,4120,2996,-885
NEVP,"12/25/2021 11 p.m. PST",3780,4000,3061,-719
NEVP,"12/26/2021 12 a.m. PST",3656,3888,3371,-285
NEVP,"12/26/2021 1 a.m. PST",3562,3774,3296,-266
NEVP,"12/26/2021 2 a.m. PST",3483,3702,3206,-277
NEVP,"12/26/2021 3 a.m. PST",3449,3640,3243,-206
NEVP,"12/26/2021 4 a.m. PST",3427,3650,3239,-188
NEVP,"12/26/2021 5 a.m. PST",3481,3677,3313,-168
NEVP,"12/26/2021 6 a.m. PST",3549,3730,3419,-130
NEVP,"12/26/2021 7 a.m. PST",3630,3769,3363,-267
NEVP,"12/26/2021 8 a.m. PST",3609,3827,2902,-707
NEVP,"12/26/2021 9 a.m. PST",3571,3821,2878,-693
NEVP,"12/26/2021 10 a.m. PST",3568,3839,3037,-531
NEVP,"12/26/2021 11 a.m. PST",3566,3868,3089,-477
NEVP,"12/26/2021 12 p.m. PST",3528,3767,3067,-461
NEVP,"12/26/2021 1 p.m. PST",3516,3725,3125,-391
NEVP,"12/26/2021 2 p.m. PST",3531,3766,3234,-297
NEVP,"12/26/2021 3 p.m. PST",3617,3780,3513,-104
NEVP,"12/26/2021 4 p.m. PST",3722,3884,3640,-82
NEVP,"12/26/2021 5 p.m. PST",4015,4145,3622,-393
NEVP,"12/26/2021 6 p.m. PST",4264,4359,3713,-551
NEVP,"12/26/2021 7 p.m. PST",4295,4360,3687,-608
NEVP,"12/26/2021 8 p.m. PST",4256,4336,3493,-763
NEVP,"12/26/2021 9 p.m. PST",4206,4307,3605,-601
NEVP,"12/26/2021 10 p.m. PST",4114,4225,3555,-559
NEVP,"12/26/2021 11 p.m. PST",3986,4043,3394,-592
NEVP,"12/27/2021 12 a.m. PST",3841,3922,3486,-355
NEVP,"12/27/2021 1 a.m. PST",3723,3827,3497,-226
NEVP,"12/27/2021 2 a.m. PST",3642,3770,3384,-258
NEVP,"12/27/2021 3 a.m. PST",3598,3753,3545,-53
NEVP,"12/27/2021 4 a.m. PST",3615,3768,3621,6
NEVP,"12/27/2021 5 a.m. PST",3669,3841,3659,-10
NEVP,"12/27/2021 6 a.m. PST",3820,4030,3645,-175
NEVP,"12/27/2021 7 a.m. PST",3979,4253,3761,-218
NEVP,"12/27/2021 8 a.m. PST",4029,4254,3762,-267
NEVP,"12/27/2021 9 a.m. PST",4064,4200,3764,-300
NEVP,"12/27/2021 10 a.m. PST",3985,4195,3889,-96
NEVP,"12/27/2021 11 a.m. PST",3956,4100,3764,-192
NEVP,"12/27/2021 12 p.m. PST",3865,4032,3711,-154
NEVP,"12/27/2021 1 p.m. PST",3939,4008,3653,-286
NEVP,"12/27/2021 2 p.m. PST",3983,3926,3614,-369
NEVP,"12/27/2021 3 p.m. PST",3947,3963,4124,177
NEVP,"12/27/2021 4 p.m. PST",4100,4050,3763,-337
NEVP,"12/27/2021 5 p.m. PST",4357,4329,3599,-758
NEVP,"12/27/2021 6 p.m. PST",4512,4473,4093,-419
NEVP,"12/27/2021 7 p.m. PST",4487,4528,4360,-127
NEVP,"12/27/2021 8 p.m. PST",4427,4479,4007,-420
NEVP,"12/27/2021 9 p.m. PST",4334,4441,3868,-466
NEVP,"12/27/2021 10 p.m. PST",4200,4358,3718,-482
NEVP,"12/27/2021 11 p.m. PST",4015,4156,3547,-468
NEVP,"12/28/2021 12 a.m. PST",3835,4012,3629,-206
NEVP,"12/28/2021 1 a.m. PST",3722,3703,3582,-140
NEVP,"12/28/2021 2 a.m. PST",3654,3615,3432,-222
NEVP,"12/28/2021 3 a.m. PST",3605,3589,3304,-301
NEVP,"12/28/2021 4 a.m. PST",3629,3591,3411,-218
NEVP,"12/28/2021 5 a.m. PST",3715,3626,3694,-21
NEVP,"12/28/2021 6 a.m. PST",3867,3731,3581,-286
NEVP,"12/28/2021 7 a.m. PST",4026,3946,3704,-322
NEVP,"12/28/2021 8 a.m. PST",4078,4152,3603,-475
NEVP,"12/28/2021 9 a.m. PST",4087,4134,3707,-380
NEVP,"12/28/2021 10 a.m. PST",4077,4026,3737,-340
NEVP,"12/28/2021 11 a.m. PST",4107,4025,3686,-421
NEVP,"12/28/2021 12 p.m. PST",4037,4072,3401,-636
NEVP,"12/28/2021 1 p.m. PST",3998,3943,3708,-290
NEVP,"12/28/2021 2 p.m. PST",4037,3946,3610,-427
NEVP,"12/28/2021 3 p.m. PST",4091,4140,3449,-642
NEVP,"12/28/2021 4 p.m. PST",4176,4204,3523,-653
NEVP,"12/28/2021 5 p.m. PST",4391,4347,3967,-424
NEVP,"12/28/2021 6 p.m. PST",4570,4490,4130,-440
NEVP,"12/28/2021 7 p.m. PST",4553,4586,4016,-537
NEVP,"12/28/2021 8 p.m. PST",4515,4540,3942,-573
NEVP,"12/28/2021 9 p.m. PST",4444,4451,3837,-607
NEVP,"12/28/2021 10 p.m. PST",4298,4401,3851,-447
NEVP,"12/28/2021 11 p.m. PST",4149,4205,3534,-615
NEVP,"12/29/2021 12 a.m. PST",3995,4078,3224,-771
NEVP,"12/29/2021 1 a.m. PST",3888,3733,3292,-596
NEVP,"12/29/2021 2 a.m. PST",3839,3660,3402,-437
NEVP,"12/29/2021 3 a.m. PST",3814,3630,3316,-498
NEVP,"12/29/2021 4 a.m. PST",3841,3637,3280,-561
NEVP,"12/29/2021 5 a.m. PST",3919,3686,3416,-503
NEVP,"12/29/2021 6 a.m. PST",4054,3819,3336,-718
NEVP,"12/29/2021 7 a.m. PST",4209,3997,3260,-949
NEVP,"12/29/2021 8 a.m. PST",4226,4012,3525,-701
NEVP,"12/29/2021 9 a.m. PST",4149,3914,3912,-237
NEVP,"12/29/2021 10 a.m. PST",4045,3880,3819,-226
NEVP,"12/29/2021 11 a.m. PST",3993,3862,3414,-579
NEVP,"12/29/2021 12 p.m. PST",3922,3847,3470,-452
NEVP,"12/29/2021 1 p.m. PST",3993,3874,3452,-541
NEVP,"12/29/2021 2 p.m. PST",4065,3918,3375,-690
NEVP,"12/29/2021 3 p.m. PST",4127,3965,3727,-400
NEVP,"12/29/2021 4 p.m. PST",4213,4062,3706,-507
NEVP,"12/29/2021 5 p.m. PST",4413,4282,3800,-613
NEVP,"12/29/2021 6 p.m. PST",4571,4451,4161,-410
NEVP,"12/29/2021 7 p.m. PST",4517,4429,4035,-482
NEVP,"12/29/2021 8 p.m. PST",4446,4368,4184,-262
NEVP,"12/29/2021 9 p.m. PST",4358,4307,4134,-224
NEVP,"12/29/2021 10 p.m. PST",4215,4171,3910,-305
NEVP,"12/29/2021 11 p.m. PST",4026,3988,3578,-448
NEVP,"12/30/2021 12 a.m. PST",3860,3837,3142,-718
NEVP,"12/30/2021 1 a.m. PST",3734,3929,3102,-632
NEVP,"12/30/2021 2 a.m. PST",3655,3856,3014,-641
NEVP,"12/30/2021 3 a.m. PST",3610,3821,2977,-633
NEVP,"12/30/2021 4 a.m. PST",3611,3839,3006,-605
NEVP,"12/30/2021 5 a.m. PST",3675,3901,3268,-407
NEVP,"12/30/2021 6 a.m. PST",3795,4038,3223,-572
NEVP,"12/30/2021 7 a.m. PST",3949,4220,3541,-408
NEVP,"12/30/2021 8 a.m. PST",4006,4201,3576,-430
NEVP,"12/30/2021 9 a.m. PST",4038,4201,3700,-338
NEVP,"12/30/2021 10 a.m. PST",4030,4204,3950,-80
NEVP,"12/30/2021 11 a.m. PST",3978,4161,3919,-59
NEVP,"12/30/2021 12 p.m. PST",3952,4126,3605,-347
NEVP,"12/30/2021 1 p.m. PST",3955,4120,3235,-720
NEVP,"12/30/2021 2 p.m. PST",3993,4130,3030,-963
NEVP,"12/30/2021 3 p.m. PST",4037,4145,2958,-1079
NEVP,"12/30/2021 4 p.m. PST",4091,4188,3128,-963
NEVP,"12/30/2021 5 p.m. PST",4258,4394,3710,-548
NEVP,"12/30/2021 6 p.m. PST",4447,4529,3890,-557
NEVP,"12/30/2021 7 p.m. PST",4402,4509,3675,-727
NEVP,"12/30/2021 8 p.m. PST",4325,4464,3792,-533
NEVP,"12/30/2021 9 p.m. PST",4242,4396,3755,-487
NEVP,"12/30/2021 10 p.m. PST",4096,4288,3614,-482
NEVP,"12/30/2021 11 p.m. PST",3928,4144,3629,-299
NEVP,"12/31/2021 12 a.m. PST",3760,3985,3643,-117
NEVP,"12/31/2021 1 a.m. PST",3634,3806,3557,-77
NEVP,"12/31/2021 2 a.m. PST",3540,3732,3582,42
NEVP,"12/31/2021 3 a.m. PST",3482,3703,3619,137
NEVP,"12/31/2021 4 a.m. PST",3465,3715,3600,135
NEVP,"12/31/2021 5 a.m. PST",3499,3768,3436,-63
NEVP,"12/31/2021 6 a.m. PST",3584,3905,3400,-184
NEVP,"12/31/2021 7 a.m. PST",3695,4057,3121,-574
NEVP,"12/31/2021 8 a.m. PST",3710,4117,2998,-712
NEVP,"12/31/2021 9 a.m. PST",3702,4091,3098,-604
NEVP,"12/31/2021 10 a.m. PST",3639,4075,3123,-516
NEVP,"12/31/2021 11 a.m. PST",3612,4037,3096,-516
NEVP,"12/31/2021 12 p.m. PST",3647,4002,3096,-551
NEVP,"12/31/2021 1 p.m. PST",3741,3976,3034,-707
NEVP,"12/31/2021 2 p.m. PST",3776,3991,3244,-532
NEVP,"12/31/2021 3 p.m. PST",3757,4026,3245,-512
NEVP,"12/31/2021 4 p.m. PST",3803,4139,3203,-600
NEVP,"12/31/2021 5 p.m. PST",4051,4320,3550,-501
NEVP,"12/31/2021 6 p.m. PST",4313,4446,3391,-922
NEVP,"12/31/2021 7 p.m. PST",4312,4419,3481,-831
NEVP,"12/31/2021 8 p.m. PST",4255,4378,3612,-643
NEVP,"12/31/2021 9 p.m. PST",4172,4322,3588,-584
NEVP,"12/31/2021 10 p.m. PST",4066,4228,3435,-631
NEVP,"12/31/2021 11 p.m. PST",3966,4095,3529,-437
NEVP,"1/1/2022 12 a.m. PST",3890,3955,3620,-270
