"BA Code","Timestamp (Hour Ending)","Demand (MWh)","Demand Forecast (MWh)","Net Generation (MWh)","Total Interchange (MWh)"
NEVP,"3/1/2022 12 a.m. PST",3510,3456,3131,-379
NEVP,"3/1/2022 1 a.m. PST",3425,3342,3112,-313
NEVP,"3/1/2022 2 a.m. PST",3368,3307,3190,-178
NEVP,"3/1/2022 3 a.m. PST",3359,3290,3003,-356
NEVP,"3/1/2022 4 a.m. PST",3379,3287,2963,-416
NEVP,"3/1/2022 5 a.m. PST",3470,3327,3082,-388
NEVP,"3/1/2022 6 a.m. PST",3650,3488,3111,-539
NEVP,"3/1/2022 7 a.m. PST",3782,3670,3300,-482
NEVP,"3/1/2022 8 a.m. PST",3730,3512,3489,-241
NEVP,"3/1/2022 9 a.m. PST",3634,3309,3456,-178
NEVP,"3/1/2022 10 a.m. PST",3599,3181,3635,36
NEVP,"3/1/2022 11 a.m. PST",3569,3125,3540,-29
NEVP,"3/1/2022 12 p.m. PST",3554,3068,3244,-310
NEVP,"3/1/2022 1 p.m. PST",3559,3059,3158,-401
NEVP,"3/1/2022 2 p.m. PST",3601,3070,3304,-297
NEVP,"3/1/2022 3 p.m. PST",3625,3142,3571,-54
NEVP,"3/1/2022 4 p.m. PST",3736,3279,3880,144
NEVP,"3/1/2022 5 p.m. PST",3854,3548,3489,-365
NEVP,"3/1/2022 6 p.m. PST",4015,3838,3362,-653
NEVP,"3/1/2022 7 p.m. PST",4093,3899,3616,-477
NEVP,"3/1/2022 8 p.m. PST",4043,3852,3561,-482
NEVP,"3/1/2022 9 p.m. PST",3950,3763,3471,-479
NEVP,"3/1/2022 10 p.m. PST",3793,3648,3448,-345
NEVP,"3/1/2022 11 p.m. PST",3628,3500,3256,-372
NEVP,"3/2/2022 12 a.m. PST",3484,3337,2963,-521
NEVP,"3/2/2022 1 a.m. PST",3365,3212,2889,-476
NEVP,"3/2/2022 2 a.m. PST",3329,3156,2947,-382
NEVP,"3/2/2022 3 a.m. PST",3301,3125,2930,-371
NEVP,"3/2/2022 4 a.m. PST",3326,3163,2939,-387
NEVP,"3/2/2022 5 a.m. PST",3413,3227,3048,-365
NEVP,"3/2/2022 6 a.m. PST",3581,3398,3128,-453
NEVP,"3/2/2022 7 a.m. PST",3695,3591,3297,-398
NEVP,"3/2/2022 8 a.m. PST",3682,3676,3653,-29
NEVP,"3/2/2022 9 a.m. PST",3615,3591,3483,-132
NEVP,"3/2/2022 10 a.m. PST",3530,3461,3461,-69
NEVP,"3/2/2022 11 a.m. PST",3491,3385,3535,44
NEVP,"3/2/2022 12 p.m. PST",3525,3335,3480,-45
NEVP,"3/2/2022 1 p.m. PST",3554,3317,3519,-35
NEVP,"3/2/2022 2 p.m. PST",3580,3319,3645,65
NEVP,"3/2/2022 3 p.m. PST",3699,3361,3934,235
NEVP,"3/2/2022 4 p.m. PST",3790,3440,4033,243
NEVP,"3/2/2022 5 p.m. PST",3881,3551,3861,-20
NEVP,"3/2/2022 6 p.m. PST",4027,3769,3490,-537
NEVP,"3/2/2022 7 p.m. PST",4132,3856,3542,-590
NEVP,"3/2/2022 8 p.m. PST",4071,3806,3534,-537
NEVP,"3/2/2022 9 p.m. PST",3945,3732,3370,-575
NEVP,"3/2/2022 10 p.m. PST",3725,3614,3281,-444
NEVP,"3/2/2022 11 p.m. PST",3600,3449,3254,-346
NEVP,"3/3/2022 12 a.m. PST",3437,3308,3021,-416
NEVP,"3/3/2022 1 a.m. PST",3328,3218,2968,-360
NEVP,"3/3/2022 2 a.m. PST",3263,3172,3056,-207
NEVP,"3/3/2022 3 a.m. PST",3232,3152,2993,-239
NEVP,"3/3/2022 4 a.m. PST",3231,3185,2976,-255
NEVP,"3/3/2022 5 a.m. PST",3299,3270,2862,-437
NEVP,"3/3/2022 6 a.m. PST",3465,3407,2960,-505
NEVP,"3/3/2022 7 a.m. PST",3592,3511,3114,-478
NEVP,"3/3/2022 8 a.m. PST",3606,3551,3553,-53
NEVP,"3/3/2022 9 a.m. PST",3547,3540,3562,15
NEVP,"3/3/2022 10 a.m. PST",3445,3493,3450,5
NEVP,"3/3/2022 11 a.m. PST",3493,3454,3509,16
NEVP,"3/3/2022 12 p.m. PST",3511,3449,3494,-17
NEVP,"3/3/2022 1 p.m. PST",3540,3516,3393,-147
NEVP,"3/3/2022 2 p.m. PST",3595,3581,3372,-223
NEVP,"3/3/2022 3 p.m. PST",3683,3619,3149,-534
NEVP,"3/3/2022 4 p.m. PST",3765,3701,3043,-722
NEVP,"3/3/2022 5 p.m. PST",3818,3758,3184,-634
NEVP,"3/3/2022 6 p.m. PST",3978,3908,3434,-544
NEVP,"3/3/2022 7 p.m. PST",4103,4017,3468,-635
NEVP,"3/3/2022 8 p.m. PST",4041,4017,3562,-479
NEVP,"3/3/2022 9 p.m. PST",3961,3906,3265,-696
NEVP,"3/3/2022 10 p.m. PST",3826,3797,3065,-761
NEVP,"3/3/2022 11 p.m. PST",3658,3639,3025,-633
NEVP,"3/4/2022 12 a.m. PST",3489,3494,2907,-582
NEVP,"3/4/2022 1 a.m. PST",3362,3244,2784,-578
NEVP,"3/4/2022 2 a.m. PST",3289,3179,2740,-549
NEVP,"3/4/2022 3 a.m. PST",3243,3169,2787,-456
NEVP,"3/4/2022 4 a.m. PST",3249,3163,2776,-473
NEVP,"3/4/2022 5 a.m. PST",3316,3260,2935,-381
NEVP,"3/4/2022 6 a.m. PST",3461,3441,3025,-436
NEVP,"3/4/2022 7 a.m. PST",3585,3557,3166,-419
NEVP,"3/4/2022 8 a.m. PST",3625,3454,3410,-215
NEVP,"3/4/2022 9 a.m. PST",3615,3427,3230,-385
NEVP,"3/4/2022 10 a.m. PST",3649,3397,2928,-721
NEVP,"3/4/2022 11 a.m. PST",3581,3369,2740,-841
NEVP,"3/4/2022 12 p.m. PST",3461,3369,2976,-485
NEVP,"3/4/2022 1 p.m. PST",3472,3384,2945,-527
NEVP,"3/4/2022 2 p.m. PST",3530,3395,2510,-1020
NEVP,"3/4/2022 3 p.m. PST",3582,3446,2858,-724
NEVP,"3/4/2022 4 p.m. PST",3620,3516,3276,-344
NEVP,"3/4/2022 5 p.m. PST",3758,3636,3205,-553
NEVP,"3/4/2022 6 p.m. PST",3931,3758,3055,-876
NEVP,"3/4/2022 7 p.m. PST",4089,3833,3322,-767
NEVP,"3/4/2022 8 p.m. PST",4044,3793,3421,-623
NEVP,"3/4/2022 9 p.m. PST",3979,3783,3357,-622
NEVP,"3/4/2022 10 p.m. PST",3888,3678,3335,-553
NEVP,"3/4/2022 11 p.m. PST",3749,3567,3157,-592
NEVP,"3/5/2022 12 a.m. PST",3603,3477,3129,-474
NEVP,"3/5/2022 1 a.m. PST",3504,3206,3084,-420
NEVP,"3/5/2022 2 a.m. PST",3443,3150,2945,-498
NEVP,"3/5/2022 3 a.m. PST",3403,3111,2883,-520
NEVP,"3/5/2022 4 a.m. PST",3396,3129,2853,-543
NEVP,"3/5/2022 5 a.m. PST",3425,3190,2910,-515
NEVP,"3/5/2022 6 a.m. PST",3500,3345,2951,-549
NEVP,"3/5/2022 7 a.m. PST",3517,3474,2877,-640
NEVP,"3/5/2022 8 a.m. PST",3480,3293,2924,-556
NEVP,"3/5/2022 9 a.m. PST",3496,3288,3185,-311
NEVP,"3/5/2022 10 a.m. PST",3489,3257,3249,-240
NEVP,"3/5/2022 11 a.m. PST",3503,3260,3294,-209
NEVP,"3/5/2022 12 p.m. PST",3544,3347,3086,-458
NEVP,"3/5/2022 1 p.m. PST",3515,3345,2849,-666
NEVP,"3/5/2022 2 p.m. PST",3496,3328,2766,-730
NEVP,"3/5/2022 3 p.m. PST",3547,3377,2585,-962
NEVP,"3/5/2022 4 p.m. PST",3612,3422,2526,-1086
NEVP,"3/5/2022 5 p.m. PST",3750,3494,2652,-1098
NEVP,"3/5/2022 6 p.m. PST",3989,3720,3160,-829
NEVP,"3/5/2022 7 p.m. PST",4140,3809,3394,-746
NEVP,"3/5/2022 8 p.m. PST",4112,3782,3344,-768
NEVP,"3/5/2022 9 p.m. PST",4064,3719,3278,-786
NEVP,"3/5/2022 10 p.m. PST",3965,3635,3162,-803
NEVP,"3/5/2022 11 p.m. PST",3856,3534,3126,-730
NEVP,"3/6/2022 12 a.m. PST",3740,3439,3035,-705
NEVP,"3/6/2022 1 a.m. PST",3640,3332,2933,-707
NEVP,"3/6/2022 2 a.m. PST",3572,3251,2850,-722
NEVP,"3/6/2022 3 a.m. PST",3524,3228,2797,-727
NEVP,"3/6/2022 4 a.m. PST",3518,3218,2782,-736
NEVP,"3/6/2022 5 a.m. PST",3545,3276,2843,-702
NEVP,"3/6/2022 6 a.m. PST",3612,3366,2894,-718
NEVP,"3/6/2022 7 a.m. PST",3598,3467,2961,-637
NEVP,"3/6/2022 8 a.m. PST",3524,3447,2995,-529
NEVP,"3/6/2022 9 a.m. PST",3480,3375,3233,-247
NEVP,"3/6/2022 10 a.m. PST",3432,3300,3149,-283
NEVP,"3/6/2022 11 a.m. PST",3435,3274,3169,-266
NEVP,"3/6/2022 12 p.m. PST",3401,3251,2885,-516
NEVP,"3/6/2022 1 p.m. PST",3408,3201,2660,-748
NEVP,"3/6/2022 2 p.m. PST",3500,3173,2871,-629
NEVP,"3/6/2022 3 p.m. PST",3541,3186,2987,-554
NEVP,"3/6/2022 4 p.m. PST",3610,3247,2932,-678
NEVP,"3/6/2022 5 p.m. PST",3691,3328,2650,-1041
NEVP,"3/6/2022 6 p.m. PST",3881,3449,3107,-774
NEVP,"3/6/2022 7 p.m. PST",4074,3588,3344,-730
NEVP,"3/6/2022 8 p.m. PST",4056,3711,3365,-691
NEVP,"3/6/2022 9 p.m. PST",4003,3708,3215,-788
NEVP,"3/6/2022 10 p.m. PST",3899,3655,3211,-688
NEVP,"3/6/2022 11 p.m. PST",3763,3529,3232,-531
NEVP,"3/7/2022 12 a.m. PST",3645,3407,2999,-646
NEVP,"3/7/2022 1 a.m. PST",3545,3318,2918,-627
NEVP,"3/7/2022 2 a.m. PST",3508,3295,2871,-637
NEVP,"3/7/2022 3 a.m. PST",3489,3316,2950,-539
NEVP,"3/7/2022 4 a.m. PST",3510,3353,3010,-500
NEVP,"3/7/2022 5 a.m. PST",3608,3429,3082,-526
NEVP,"3/7/2022 6 a.m. PST",3793,3598,3450,-343
NEVP,"3/7/2022 7 a.m. PST",3913,3788,3633,-280
NEVP,"3/7/2022 8 a.m. PST",3866,3764,3828,-38
NEVP,"3/7/2022 9 a.m. PST",3800,3659,3608,-192
NEVP,"3/7/2022 10 a.m. PST",3728,3525,3458,-270
NEVP,"3/7/2022 11 a.m. PST",3671,3458,3558,-113
NEVP,"3/7/2022 12 p.m. PST",3619,3408,3469,-150
NEVP,"3/7/2022 1 p.m. PST",3583,3383,3399,-184
NEVP,"3/7/2022 2 p.m. PST",3545,3365,3501,-44
NEVP,"3/7/2022 3 p.m. PST",3563,3371,3487,-76
NEVP,"3/7/2022 4 p.m. PST",3637,3414,3419,-218
NEVP,"3/7/2022 5 p.m. PST",3774,3436,3055,-719
NEVP,"3/7/2022 6 p.m. PST",4022,3539,3057,-965
NEVP,"3/7/2022 7 p.m. PST",4245,3739,3473,-772
NEVP,"3/7/2022 8 p.m. PST",4216,3871,3448,-768
NEVP,"3/7/2022 9 p.m. PST",4096,3871,3357,-739
NEVP,"3/7/2022 10 p.m. PST",3921,3762,3344,-577
NEVP,"3/7/2022 11 p.m. PST",3748,3613,3257,-491
NEVP,"3/8/2022 12 a.m. PST",3613,3479,3049,-564
NEVP,"3/8/2022 1 a.m. PST",3526,3425,3007,-519
NEVP,"3/8/2022 2 a.m. PST",3587,3386,3021,-566
NEVP,"3/8/2022 3 a.m. PST",3568,3351,3066,-502
NEVP,"3/8/2022 4 a.m. PST",3591,3343,3085,-506
NEVP,"3/8/2022 5 a.m. PST",3683,3378,3239,-444
NEVP,"3/8/2022 6 a.m. PST",3863,3443,3513,-350
NEVP,"3/8/2022 7 a.m. PST",3961,3629,3803,-158
NEVP,"3/8/2022 8 a.m. PST",3907,3745,3832,-75
NEVP,"3/8/2022 9 a.m. PST",3791,3610,3679,-112
NEVP,"3/8/2022 10 a.m. PST",3679,3508,3331,-348
NEVP,"3/8/2022 11 a.m. PST",3592,3422,3186,-406
NEVP,"3/8/2022 12 p.m. PST",3523,3389,3198,-325
NEVP,"3/8/2022 1 p.m. PST",3523,3354,3255,-268
NEVP,"3/8/2022 2 p.m. PST",3539,3358,3247,-292
NEVP,"3/8/2022 3 p.m. PST",3540,3391,3355,-185
NEVP,"3/8/2022 4 p.m. PST",3591,3465,3763,172
NEVP,"3/8/2022 5 p.m. PST",3751,3580,3597,-154
NEVP,"3/8/2022 6 p.m. PST",3936,3736,3330,-606
NEVP,"3/8/2022 7 p.m. PST",4133,3952,3634,-499
NEVP,"3/8/2022 8 p.m. PST",4111,3913,3639,-472
NEVP,"3/8/2022 9 p.m. PST",4059,3849,3662,-397
NEVP,"3/8/2022 10 p.m. PST",3926,3761,3458,-468
NEVP,"3/8/2022 11 p.m. PST",3752,3656,3237,-515
NEVP,"3/9/2022 12 a.m. PST",3611,3555,3211,-400
NEVP,"3/9/2022 1 a.m. PST",3509,3428,3215,-294
NEVP,"3/9/2022 2 a.m. PST",3467,3385,3159,-308
NEVP,"3/9/2022 3 a.m. PST",3449,3360,3195,-254
NEVP,"3/9/2022 4 a.m. PST",3478,3351,3184,-294
NEVP,"3/9/2022 5 a.m. PST",3561,3396,3251,-310
NEVP,"3/9/2022 6 a.m. PST",3751,3553,3382,-369
NEVP,"3/9/2022 7 a.m. PST",3858,3755,3399,-459
NEVP,"3/9/2022 8 a.m. PST",3815,3659,3638,-177
NEVP,"3/9/2022 9 a.m. PST",3734,3547,3343,-391
NEVP,"3/9/2022 10 a.m. PST",3635,3449,3185,-450
NEVP,"3/9/2022 11 a.m. PST",3585,3379,3278,-307
NEVP,"3/9/2022 12 p.m. PST",3565,3329,3267,-298
NEVP,"3/9/2022 1 p.m. PST",3554,3294,3269,-285
NEVP,"3/9/2022 2 p.m. PST",3594,3307,3337,-257
NEVP,"3/9/2022 3 p.m. PST",3687,3330,3413,-274
NEVP,"3/9/2022 4 p.m. PST",3739,3398,3472,-267
NEVP,"3/9/2022 5 p.m. PST",3808,3427,3292,-516
NEVP,"3/9/2022 6 p.m. PST",3869,3611,3215,-654
NEVP,"3/9/2022 7 p.m. PST",4026,3813,3413,-613
NEVP,"3/9/2022 8 p.m. PST",3992,3889,3467,-525
NEVP,"3/9/2022 9 p.m. PST",3941,3880,3587,-354
NEVP,"3/9/2022 10 p.m. PST",3778,3744,3424,-354
NEVP,"3/9/2022 11 p.m. PST",3604,3579,3047,-557
NEVP,"3/10/2022 12 a.m. PST",3442,3430,2848,-594
NEVP,"3/10/2022 1 a.m. PST",3342,3227,2765,-577
NEVP,"3/10/2022 2 a.m. PST",3279,3183,2749,-530
NEVP,"3/10/2022 3 a.m. PST",3267,3171,2742,-525
NEVP,"3/10/2022 4 a.m. PST",3267,3207,2757,-510
NEVP,"3/10/2022 5 a.m. PST",3354,3306,2830,-524
NEVP,"3/10/2022 6 a.m. PST",3512,3481,2973,-539
NEVP,"3/10/2022 7 a.m. PST",3672,3720,3103,-569
NEVP,"3/10/2022 8 a.m. PST",3765,3681,3301,-464
NEVP,"3/10/2022 9 a.m. PST",3858,3587,2600,-1258
NEVP,"3/10/2022 10 a.m. PST",3876,3488,2459,-1417
NEVP,"3/10/2022 11 a.m. PST",3774,3440,2934,-840
NEVP,"3/10/2022 12 p.m. PST",3636,3405,3231,-405
NEVP,"3/10/2022 1 p.m. PST",3554,3392,3203,-351
NEVP,"3/10/2022 2 p.m. PST",3492,3387,3241,-251
NEVP,"3/10/2022 3 p.m. PST",3570,3427,3547,-23
NEVP,"3/10/2022 4 p.m. PST",3629,3506,3719,90
NEVP,"3/10/2022 5 p.m. PST",3756,3661,3456,-300
NEVP,"3/10/2022 6 p.m. PST",3978,3897,3402,-576
NEVP,"3/10/2022 7 p.m. PST",4226,4097,3651,-575
NEVP,"3/10/2022 8 p.m. PST",4237,4074,3665,-572
NEVP,"3/10/2022 9 p.m. PST",4174,4022,3511,-663
NEVP,"3/10/2022 10 p.m. PST",4059,3856,3393,-666
NEVP,"3/10/2022 11 p.m. PST",3860,3702,3098,-762
NEVP,"3/11/2022 12 a.m. PST",3726,3568,2921,-805
NEVP,"3/11/2022 1 a.m. PST",3610,3320,2854,-756
NEVP,"3/11/2022 2 a.m. PST",3566,3249,2858,-708
NEVP,"3/11/2022 3 a.m. PST",3542,3221,2960,-582
NEVP,"3/11/2022 4 a.m. PST",3568,3228,3036,-532
NEVP,"3/11/2022 5 a.m. PST",3655,3297,3080,-575
NEVP,"3/11/2022 6 a.m. PST",3817,3505,3362,-455
NEVP,"3/11/2022 7 a.m. PST",3921,3623,3521,-400
NEVP,"3/11/2022 8 a.m. PST",3863,3665,3764,-99
NEVP,"3/11/2022 9 a.m. PST",3763,3599,3709,-54
NEVP,"3/11/2022 10 a.m. PST",3648,3547,3665,17
NEVP,"3/11/2022 11 a.m. PST",3591,3501,3518,-73
NEVP,"3/11/2022 12 p.m. PST",3528,3443,3443,-85
NEVP,"3/11/2022 1 p.m. PST",3435,3391,3342,-93
NEVP,"3/11/2022 2 p.m. PST",3431,3373,3412,-19
NEVP,"3/11/2022 3 p.m. PST",3431,3390,3590,159
NEVP,"3/11/2022 4 p.m. PST",3502,3486,3773,271
NEVP,"3/11/2022 5 p.m. PST",3600,3604,3401,-199
NEVP,"3/11/2022 6 p.m. PST",3780,3808,3201,-579
NEVP,"3/11/2022 7 p.m. PST",3962,3993,3307,-655
NEVP,"3/11/2022 8 p.m. PST",3957,3967,3311,-646
NEVP,"3/11/2022 9 p.m. PST",3918,3907,3229,-689
NEVP,"3/11/2022 10 p.m. PST",3840,3795,3265,-575
NEVP,"3/11/2022 11 p.m. PST",3720,3630,3125,-595
NEVP,"3/12/2022 12 a.m. PST",3608,3465,3054,-554
NEVP,"3/12/2022 1 a.m. PST",3509,3352,2978,-531
NEVP,"3/12/2022 2 a.m. PST",3457,3301,2970,-487
NEVP,"3/12/2022 3 a.m. PST",3436,3264,2981,-455
NEVP,"3/12/2022 4 a.m. PST",3433,3262,2969,-464
NEVP,"3/12/2022 5 a.m. PST",3477,3296,2946,-531
NEVP,"3/12/2022 6 a.m. PST",3560,3344,3042,-518
NEVP,"3/12/2022 7 a.m. PST",3537,3429,3117,-420
NEVP,"3/12/2022 8 a.m. PST",3473,3384,3200,-273
NEVP,"3/12/2022 9 a.m. PST",3414,3311,3369,-45
NEVP,"3/12/2022 10 a.m. PST",3353,3257,3362,9
NEVP,"3/12/2022 11 a.m. PST",3325,3212,3250,-75
NEVP,"3/12/2022 12 p.m. PST",3274,3157,3186,-88
NEVP,"3/12/2022 1 p.m. PST",3230,3155,3185,-45
NEVP,"3/12/2022 2 p.m. PST",3223,3183,3243,20
NEVP,"3/12/2022 3 p.m. PST",3281,3246,3447,166
NEVP,"3/12/2022 4 p.m. PST",3363,3355,3574,211
NEVP,"3/12/2022 5 p.m. PST",3489,3456,3164,-325
NEVP,"3/12/2022 6 p.m. PST",3663,3618,3092,-571
NEVP,"3/12/2022 7 p.m. PST",3825,3802,3267,-558
NEVP,"3/12/2022 8 p.m. PST",3792,3761,3397,-395
NEVP,"3/12/2022 9 p.m. PST",3734,3702,3169,-565
NEVP,"3/12/2022 10 p.m. PST",3653,3603,2908,-745
NEVP,"3/12/2022 11 p.m. PST",3549,3477,2826,-723
NEVP,"3/13/2022 12 a.m. PST",3432,3353,2753,-679
NEVP,"3/13/2022 1 a.m. PST",3349,3273,2810,-539
NEVP,"3/13/2022 3 a.m. PDT",3295,3220,2644,-651
NEVP,"3/13/2022 4 a.m. PDT",3272,3296,2644,-628
NEVP,"3/13/2022 5 a.m. PDT",3284,3385,2682,-602
NEVP,"3/13/2022 6 a.m. PDT",3332,3475,2799,-533
NEVP,"3/13/2022 7 a.m. PDT",3390,3497,2727,-663
NEVP,"3/13/2022 8 a.m. PDT",3394,3481,2814,-580
NEVP,"3/13/2022 9 a.m. PDT",3527,3432,3056,-471
NEVP,"3/13/2022 10 a.m. PDT",3521,3385,2976,-545
NEVP,"3/13/2022 11 a.m. PDT",3505,3362,3041,-464
NEVP,"3/13/2022 12 p.m. PDT",3478,3322,2943,-535
NEVP,"3/13/2022 1 p.m. PDT",3364,3336,3027,-337
NEVP,"3/13/2022 2 p.m. PDT",3330,3409,3180,-150
NEVP,"3/13/2022 3 p.m. PDT",3333,3496,3219,-114
NEVP,"3/13/2022 4 p.m. PDT",3380,3594,3515,135
NEVP,"3/13/2022 5 p.m. PDT",3480,3713,3578,98
NEVP,"3/13/2022 6 p.m. PDT",3626,3858,3049,-577
NEVP,"3/13/2022 7 p.m. PDT",3770,3882,2556,-1214
NEVP,"3/13/2022 8 p.m. PDT",3928,3817,2892,-1036
NEVP,"3/13/2022 9 p.m. PDT",3815,3695,3047,-768
NEVP,"3/13/2022 10 p.m. PDT",3645,3542,2794,-851
NEVP,"3/13/2022 11 p.m. PDT",3554,3393,2628,-926
NEVP,"3/14/2022 12 a.m. PDT",3413,3271,2648,-765
NEVP,"3/14/2022 1 a.m. PDT",3301,3176,2671,-630
NEVP,"3/14/2022 2 a.m. PDT",3232,3162,2618,-614
NEVP,"3/14/2022 3 a.m. PDT",3207,3241,2650,-557
NEVP,"3/14/2022 4 a.m. PDT",3213,3330,2612,-601
NEVP,"3/14/2022 5 a.m. PDT",3263,3474,2590,-673
NEVP,"3/14/2022 6 a.m. PDT",3412,3614,2670,-742
NEVP,"3/14/2022 7 a.m. PDT",3685,3576,3009,-676
NEVP,"3/14/2022 8 a.m. PDT",3724,3485,3264,-460
NEVP,"3/14/2022 9 a.m. PDT",3686,3435,3517,-169
NEVP,"3/14/2022 10 a.m. PDT",3666,3375,3513,-153
NEVP,"3/14/2022 11 a.m. PDT",3616,3328,3376,-240
NEVP,"3/14/2022 12 p.m. PDT",3566,3292,3316,-250
NEVP,"3/14/2022 1 p.m. PDT",3577,3319,3032,-545
NEVP,"3/14/2022 2 p.m. PDT",3575,3395,2905,-670
NEVP,"3/14/2022 3 p.m. PDT",3512,3514,3089,-423
NEVP,"3/14/2022 4 p.m. PDT",3574,3610,3421,-153
NEVP,"3/14/2022 5 p.m. PDT",3667,3750,3528,-139
NEVP,"3/14/2022 6 p.m. PDT",3747,3906,3244,-503
NEVP,"3/14/2022 7 p.m. PDT",3868,3861,3160,-708
NEVP,"3/14/2022 8 p.m. PDT",4030,3786,3445,-585
NEVP,"3/14/2022 9 p.m. PDT",3973,3658,3428,-545
NEVP,"3/14/2022 10 p.m. PDT",3853,3512,3408,-445
NEVP,"3/14/2022 11 p.m. PDT",3664,3364,2969,-695
NEVP,"3/15/2022 12 a.m. PDT",3501,3241,2829,-672
NEVP,"3/15/2022 1 a.m. PDT",3355,3141,2812,-543
NEVP,"3/15/2022 2 a.m. PDT",3289,3058,2842,-447
NEVP,"3/15/2022 3 a.m. PDT",3252,3026,2908,-344
NEVP,"3/15/2022 4 a.m. PDT",3254,3040,2965,-289
NEVP,"3/15/2022 5 a.m. PDT",3320,3124,2986,-334
NEVP,"3/15/2022 6 a.m. PDT",3466,3248,2997,-469
NEVP,"3/15/2022 7 a.m. PDT",3665,3396,3064,-601
NEVP,"3/15/2022 8 a.m. PDT",3704,3516,3146,-558
NEVP,"3/15/2022 9 a.m. PDT",3663,3438,3062,-601
NEVP,"3/15/2022 10 a.m. PDT",3615,3417,2840,-775
NEVP,"3/15/2022 11 a.m. PDT",3560,3385,2931,-629
NEVP,"3/15/2022 12 p.m. PDT",3507,3353,2995,-512
NEVP,"3/15/2022 1 p.m. PDT",3499,3407,2988,-511
NEVP,"3/15/2022 2 p.m. PDT",3543,3518,3010,-533
NEVP,"3/15/2022 3 p.m. PDT",3608,3544,3058,-550
NEVP,"3/15/2022 4 p.m. PDT",3700,3768,2989,-711
NEVP,"3/15/2022 5 p.m. PDT",3785,3845,3090,-695
NEVP,"3/15/2022 6 p.m. PDT",3810,3942,3057,-753
NEVP,"3/15/2022 7 p.m. PDT",3915,4021,3135,-780
NEVP,"3/15/2022 8 p.m. PDT",4068,4093,3289,-779
NEVP,"3/15/2022 9 p.m. PDT",4014,3974,3323,-691
NEVP,"3/15/2022 10 p.m. PDT",3882,3783,3214,-668
NEVP,"3/15/2022 11 p.m. PDT",3695,3718,2999,-696
NEVP,"3/16/2022 12 a.m. PDT",3519,3475,2866,-653
NEVP,"3/16/2022 1 a.m. PDT",3378,3220,2942,-436
NEVP,"3/16/2022 2 a.m. PDT",3294,3158,2698,-596
NEVP,"3/16/2022 3 a.m. PDT",3246,3137,2688,-558
NEVP,"3/16/2022 4 a.m. PDT",3240,3139,2711,-529
NEVP,"3/16/2022 5 a.m. PDT",3284,3190,2837,-447
NEVP,"3/16/2022 6 a.m. PDT",3407,3322,2989,-418
NEVP,"3/16/2022 7 a.m. PDT",3619,3504,2960,-659
NEVP,"3/16/2022 8 a.m. PDT",3655,3601,3144,-511
NEVP,"3/16/2022 9 a.m. PDT",3615,3546,3589,-26
NEVP,"3/16/2022 10 a.m. PDT",3590,3480,3196,-394
NEVP,"3/16/2022 11 a.m. PDT",3543,3415,3042,-501
NEVP,"3/16/2022 12 p.m. PDT",3510,3379,3131,-379
NEVP,"3/16/2022 1 p.m. PDT",3501,3376,3092,-409
NEVP,"3/16/2022 2 p.m. PDT",3544,3366,3088,-456
NEVP,"3/16/2022 3 p.m. PDT",3585,3384,3158,-427
NEVP,"3/16/2022 4 p.m. PDT",3678,3459,2969,-709
NEVP,"3/16/2022 5 p.m. PDT",3741,3589,2882,-859
NEVP,"3/16/2022 6 p.m. PDT",3820,3709,2940,-880
NEVP,"3/16/2022 7 p.m. PDT",3904,3817,2932,-972
NEVP,"3/16/2022 8 p.m. PDT",4051,3961,3284,-767
NEVP,"3/16/2022 9 p.m. PDT",4018,3867,3327,-691
NEVP,"3/16/2022 10 p.m. PDT",3870,3724,3167,-703
NEVP,"3/16/2022 11 p.m. PDT",3693,3572,2945,-748
NEVP,"3/17/2022 12 a.m. PDT",3510,3412,2928,-582
NEVP,"3/17/2022 1 a.m. PDT",3380,3283,2946,-434
NEVP,"3/17/2022 2 a.m. PDT",3302,3217,2798,-504
NEVP,"3/17/2022 3 a.m. PDT",3258,3193,2710,-548
NEVP,"3/17/2022 4 a.m. PDT",3256,3191,2715,-541
NEVP,"3/17/2022 5 a.m. PDT",3301,3247,2808,-493
NEVP,"3/17/2022 6 a.m. PDT",3450,3379,2975,-475
NEVP,"3/17/2022 7 a.m. PDT",3653,3561,3077,-576
NEVP,"3/17/2022 8 a.m. PDT",3680,3637,3373,-307
NEVP,"3/17/2022 9 a.m. PDT",3653,3597,3851,198
NEVP,"3/17/2022 10 a.m. PDT",3606,3531,3629,23
NEVP,"3/17/2022 11 a.m. PDT",3557,3439,3418,-139
NEVP,"3/17/2022 12 p.m. PDT",3476,3386,3225,-251
NEVP,"3/17/2022 1 p.m. PDT",3514,3356,3113,-401
NEVP,"3/17/2022 2 p.m. PDT",3495,3398,3160,-335
NEVP,"3/17/2022 3 p.m. PDT",3555,3430,3194,-361
NEVP,"3/17/2022 4 p.m. PDT",3640,3464,3044,-596
NEVP,"3/17/2022 5 p.m. PDT",3739,3548,2613,-1126
NEVP,"3/17/2022 6 p.m. PDT",3775,3744,2977,-798
NEVP,"3/17/2022 7 p.m. PDT",3850,3882,3177,-673
NEVP,"3/17/2022 8 p.m. PDT",3994,3925,3392,-602
NEVP,"3/17/2022 9 p.m. PDT",3918,3915,3224,-694
NEVP,"3/17/2022 10 p.m. PDT",3837,3781,3199,-638
NEVP,"3/17/2022 11 p.m. PDT",3671,3627,2922,-749
NEVP,"3/18/2022 12 a.m. PDT",3501,3461,2861,-641
NEVP,"3/18/2022 1 a.m. PDT",3378,3372,2761,-617
NEVP,"3/18/2022 2 a.m. PDT",3323,3322,2770,-553
NEVP,"3/18/2022 3 a.m. PDT",3281,3284,2743,-538
NEVP,"3/18/2022 4 a.m. PDT",3309,3242,2733,-576
NEVP,"3/18/2022 5 a.m. PDT",3369,3324,2741,-628
NEVP,"3/18/2022 6 a.m. PDT",3514,3490,2901,-613
NEVP,"3/18/2022 7 a.m. PDT",3723,3554,3068,-655
NEVP,"3/18/2022 8 a.m. PDT",3746,3553,3598,-148
NEVP,"3/18/2022 9 a.m. PDT",3704,3513,3868,164
NEVP,"3/18/2022 10 a.m. PDT",3633,3487,3607,-26
NEVP,"3/18/2022 11 a.m. PDT",3563,3449,3532,-31
NEVP,"3/18/2022 12 p.m. PDT",3516,3387,3421,-95
NEVP,"3/18/2022 1 p.m. PDT",3483,3385,3169,-314
NEVP,"3/18/2022 2 p.m. PDT",3494,3439,3147,-347
NEVP,"3/18/2022 3 p.m. PDT",3525,3512,3213,-312
NEVP,"3/18/2022 4 p.m. PDT",3600,3617,3442,-158
NEVP,"3/18/2022 5 p.m. PDT",3697,3626,3512,-185
NEVP,"3/18/2022 6 p.m. PDT",3786,3855,3423,-363
NEVP,"3/18/2022 7 p.m. PDT",3861,3954,3291,-570
NEVP,"3/18/2022 8 p.m. PDT",4003,3955,3453,-550
NEVP,"3/18/2022 9 p.m. PDT",3936,3953,3337,-599
NEVP,"3/18/2022 10 p.m. PDT",3834,3803,3249,-585
NEVP,"3/18/2022 11 p.m. PDT",3668,3664,3006,-662
NEVP,"3/19/2022 12 a.m. PDT",3504,3518,2875,-629
NEVP,"3/19/2022 1 a.m. PDT",3358,3294,2858,-500
NEVP,"3/19/2022 2 a.m. PDT",3277,3227,2737,-540
NEVP,"3/19/2022 3 a.m. PDT",3215,3177,2605,-610
NEVP,"3/19/2022 4 a.m. PDT",3197,3170,2553,-644
NEVP,"3/19/2022 5 a.m. PDT",3216,3234,2576,-640
NEVP,"3/19/2022 6 a.m. PDT",3282,3364,2642,-640
NEVP,"3/19/2022 7 a.m. PDT",3362,3561,2664,-698
NEVP,"3/19/2022 8 a.m. PDT",3373,3274,2848,-525
NEVP,"3/19/2022 9 a.m. PDT",3431,3304,3071,-360
NEVP,"3/19/2022 10 a.m. PDT",3511,3295,3370,-141
NEVP,"3/19/2022 11 a.m. PDT",3422,3266,3604,182
NEVP,"3/19/2022 12 p.m. PDT",3464,3288,3063,-401
NEVP,"3/19/2022 1 p.m. PDT",3474,3294,2799,-675
NEVP,"3/19/2022 2 p.m. PDT",3412,3323,2821,-591
NEVP,"3/19/2022 3 p.m. PDT",3453,3344,2854,-599
NEVP,"3/19/2022 4 p.m. PDT",3538,3417,3099,-439
NEVP,"3/19/2022 5 p.m. PDT",3658,3521,3209,-449
NEVP,"3/19/2022 6 p.m. PDT",3715,3622,3219,-496
NEVP,"3/19/2022 7 p.m. PDT",3812,3766,3282,-530
NEVP,"3/19/2022 8 p.m. PDT",3950,3854,3338,-612
NEVP,"3/19/2022 9 p.m. PDT",3905,3796,3304,-601
NEVP,"3/19/2022 10 p.m. PDT",3805,3702,3280,-525
NEVP,"3/19/2022 11 p.m. PDT",3694,3551,3051,-643
NEVP,"3/20/2022 12 a.m. PDT",3533,3412,2947,-586
NEVP,"3/20/2022 1 a.m. PDT",3405,3313,2789,-616
NEVP,"3/20/2022 2 a.m. PDT",3329,3219,2599,-730
NEVP,"3/20/2022 3 a.m. PDT",3287,3204,2578,-709
NEVP,"3/20/2022 4 a.m. PDT",3238,3202,2505,-733
NEVP,"3/20/2022 5 a.m. PDT",3235,3206,2593,-642
NEVP,"3/20/2022 6 a.m. PDT",3286,3232,2638,-648
NEVP,"3/20/2022 7 a.m. PDT",3344,3266,2634,-710
NEVP,"3/20/2022 8 a.m. PDT",3322,3279,2931,-391
NEVP,"3/20/2022 9 a.m. PDT",3357,3303,3300,-57
NEVP,"3/20/2022 10 a.m. PDT",3429,3265,2942,-487
NEVP,"3/20/2022 11 a.m. PDT",3517,3249,2511,-1006
NEVP,"3/20/2022 12 p.m. PDT",3441,3241,2445,-996
NEVP,"3/20/2022 1 p.m. PDT",3390,3225,2636,-754
NEVP,"3/20/2022 2 p.m. PDT",3297,3236,2869,-428
NEVP,"3/20/2022 3 p.m. PDT",3301,3245,3314,13
NEVP,"3/20/2022 4 p.m. PDT",3359,3301,3485,126
NEVP,"3/20/2022 5 p.m. PDT",3460,3342,3507,47
NEVP,"3/20/2022 6 p.m. PDT",3577,3506,3147,-430
NEVP,"3/20/2022 7 p.m. PDT",3681,3679,2863,-818
NEVP,"3/20/2022 8 p.m. PDT",3865,3794,3099,-766
NEVP,"3/20/2022 9 p.m. PDT",3849,3768,3140,-709
NEVP,"3/20/2022 10 p.m. PDT",3741,3656,3006,-735
NEVP,"3/20/2022 11 p.m. PDT",3603,3534,3041,-562
NEVP,"3/21/2022 12 a.m. PDT",3450,3395,3016,-434
NEVP,"3/21/2022 1 a.m. PDT",3336,3294,2800,-536
NEVP,"3/21/2022 2 a.m. PDT",3265,3226,2732,-533
NEVP,"3/21/2022 3 a.m. PDT",3234,3220,2697,-537
NEVP,"3/21/2022 4 a.m. PDT",3251,3235,2731,-520
NEVP,"3/21/2022 5 a.m. PDT",3317,3245,2756,-561
NEVP,"3/21/2022 6 a.m. PDT",3479,3393,2814,-665
NEVP,"3/21/2022 7 a.m. PDT",3687,3573,3130,-557
NEVP,"3/21/2022 8 a.m. PDT",3715,3617,3385,-330
NEVP,"3/21/2022 9 a.m. PDT",3682,3543,3636,-46
NEVP,"3/21/2022 10 a.m. PDT",3612,3501,3401,-211
NEVP,"3/21/2022 11 a.m. PDT",3540,3415,3399,-141
NEVP,"3/21/2022 12 p.m. PDT",3495,3394,3260,-235
NEVP,"3/21/2022 1 p.m. PDT",3474,3367,3204,-270
NEVP,"3/21/2022 2 p.m. PDT",3465,3391,3158,-307
NEVP,"3/21/2022 3 p.m. PDT",3484,3390,3235,-249
NEVP,"3/21/2022 4 p.m. PDT",3551,3458,3388,-163
NEVP,"3/21/2022 5 p.m. PDT",3679,3523,3535,-144
NEVP,"3/21/2022 6 p.m. PDT",3797,3713,3285,-512
NEVP,"3/21/2022 7 p.m. PDT",3893,3829,3176,-717
NEVP,"3/21/2022 8 p.m. PDT",4014,3922,3457,-557
NEVP,"3/21/2022 9 p.m. PDT",3947,3882,3316,-631
NEVP,"3/21/2022 10 p.m. PDT",3885,3747,3261,-624
NEVP,"3/21/2022 11 p.m. PDT",3643,3565,2941,-702
NEVP,"3/22/2022 12 a.m. PDT",3437,3420,2892,-545
NEVP,"3/22/2022 1 a.m. PDT",3308,3283,2867,-441
NEVP,"3/22/2022 2 a.m. PDT",3237,3208,2755,-482
NEVP,"3/22/2022 3 a.m. PDT",3192,3185,2702,-490
NEVP,"3/22/2022 4 a.m. PDT",3196,3174,2718,-478
NEVP,"3/22/2022 5 a.m. PDT",3258,3178,2726,-532
NEVP,"3/22/2022 6 a.m. PDT",3406,3347,2797,-609
NEVP,"3/22/2022 7 a.m. PDT",3603,3521,2835,-768
NEVP,"3/22/2022 8 a.m. PDT",3620,3506,3404,-216
NEVP,"3/22/2022 9 a.m. PDT",3578,3450,3621,43
NEVP,"3/22/2022 10 a.m. PDT",3540,3452,3334,-206
NEVP,"3/22/2022 11 a.m. PDT",3508,3387,3400,-108
NEVP,"3/22/2022 12 p.m. PDT",3511,3360,3240,-271
NEVP,"3/22/2022 1 p.m. PDT",3466,3349,3386,-80
NEVP,"3/22/2022 2 p.m. PDT",3484,3368,3353,-131
NEVP,"3/22/2022 3 p.m. PDT",3546,3431,3330,-216
NEVP,"3/22/2022 4 p.m. PDT",3659,3491,3340,-319
NEVP,"3/22/2022 5 p.m. PDT",3777,3613,3358,-419
NEVP,"3/22/2022 6 p.m. PDT",3845,3779,3236,-609
NEVP,"3/22/2022 7 p.m. PDT",3933,3879,2999,-934
NEVP,"3/22/2022 8 p.m. PDT",4059,3978,3241,-818
NEVP,"3/22/2022 9 p.m. PDT",4017,3886,3372,-645
NEVP,"3/22/2022 10 p.m. PDT",3873,3752,3157,-716
NEVP,"3/22/2022 11 p.m. PDT",3677,3590,3117,-560
NEVP,"3/23/2022 12 a.m. PDT",3493,3437,3039,-454
NEVP,"3/23/2022 1 a.m. PDT",3347,3255,2906,-441
NEVP,"3/23/2022 2 a.m. PDT",3268,3168,2889,-379
NEVP,"3/23/2022 3 a.m. PDT",3209,3114,2801,-408
NEVP,"3/23/2022 4 a.m. PDT",3197,3122,2802,-395
NEVP,"3/23/2022 5 a.m. PDT",3311,3146,2833,-478
NEVP,"3/23/2022 6 a.m. PDT",3417,3319,2798,-619
NEVP,"3/23/2022 7 a.m. PDT",3602,3481,2885,-717
NEVP,"3/23/2022 8 a.m. PDT",3579,3518,3213,-366
NEVP,"3/23/2022 9 a.m. PDT",3518,3438,3202,-316
NEVP,"3/23/2022 10 a.m. PDT",3467,3437,3430,-37
NEVP,"3/23/2022 11 a.m. PDT",3446,3365,3334,-112
NEVP,"3/23/2022 12 p.m. PDT",3525,3343,3417,-108
NEVP,"3/23/2022 1 p.m. PDT",3526,3351,3465,-61
NEVP,"3/23/2022 2 p.m. PDT",3555,3406,3384,-171
NEVP,"3/23/2022 3 p.m. PDT",3639,3484,3382,-257
NEVP,"3/23/2022 4 p.m. PDT",3742,3543,3346,-396
NEVP,"3/23/2022 5 p.m. PDT",3842,3620,3284,-558
NEVP,"3/23/2022 6 p.m. PDT",3936,3883,3257,-679
NEVP,"3/23/2022 7 p.m. PDT",4007,3917,2993,-1014
NEVP,"3/23/2022 8 p.m. PDT",4107,3972,3344,-763
NEVP,"3/23/2022 9 p.m. PDT",4038,3926,3526,-512
NEVP,"3/23/2022 10 p.m. PDT",3877,3792,3292,-585
NEVP,"3/23/2022 11 p.m. PDT",3669,3598,3058,-611
NEVP,"3/24/2022 12 a.m. PDT",3470,3399,3110,-360
NEVP,"3/24/2022 1 a.m. PDT",3324,3234,2981,-343
NEVP,"3/24/2022 2 a.m. PDT",3230,3144,2945,-285
NEVP,"3/24/2022 3 a.m. PDT",3180,3122,2715,-465
NEVP,"3/24/2022 4 a.m. PDT",3163,3085,2807,-356
NEVP,"3/24/2022 5 a.m. PDT",3221,3127,2727,-494
NEVP,"3/24/2022 6 a.m. PDT",3361,3275,2683,-678
NEVP,"3/24/2022 7 a.m. PDT",3541,3490,2876,-665
NEVP,"3/24/2022 8 a.m. PDT",3586,3519,3343,-243
NEVP,"3/24/2022 9 a.m. PDT",3584,3472,3347,-237
NEVP,"3/24/2022 10 a.m. PDT",3566,3411,3417,-149
NEVP,"3/24/2022 11 a.m. PDT",3557,3350,3343,-214
NEVP,"3/24/2022 12 p.m. PDT",3567,3360,3336,-231
NEVP,"3/24/2022 1 p.m. PDT",3599,3362,3438,-161
NEVP,"3/24/2022 2 p.m. PDT",3663,3400,3401,-262
NEVP,"3/24/2022 3 p.m. PDT",3768,3449,3440,-328
NEVP,"3/24/2022 4 p.m. PDT",3886,3545,3472,-414
NEVP,"3/24/2022 5 p.m. PDT",4036,3656,3716,-320
NEVP,"3/24/2022 6 p.m. PDT",4131,3755,3680,-451
NEVP,"3/24/2022 7 p.m. PDT",4178,3839,3359,-819
NEVP,"3/24/2022 8 p.m. PDT",4283,3962,3419,-864
NEVP,"3/24/2022 9 p.m. PDT",4169,3913,3275,-894
NEVP,"3/24/2022 10 p.m. PDT",4045,3784,3217,-828
NEVP,"3/24/2022 11 p.m. PDT",3822,3600,3232,-590
NEVP,"3/25/2022 12 a.m. PDT",3596,3428,3127,-470
NEVP,"3/25/2022 1 a.m. PDT",3423,3138,2763,-660
NEVP,"3/25/2022 2 a.m. PDT",3306,3049,2695,-611
NEVP,"3/25/2022 3 a.m. PDT",3234,3043,2769,-465
NEVP,"3/25/2022 4 a.m. PDT",3205,3035,2635,-570
NEVP,"3/25/2022 5 a.m. PDT",3247,3082,2661,-586
NEVP,"3/25/2022 6 a.m. PDT",3357,3225,2648,-709
NEVP,"3/25/2022 7 a.m. PDT",3509,3414,2632,-877
NEVP,"3/25/2022 8 a.m. PDT",3474,3420,2792,-682
NEVP,"3/25/2022 9 a.m. PDT",3589,3385,3452,-137
NEVP,"3/25/2022 10 a.m. PDT",3616,3402,3596,-20
NEVP,"3/25/2022 11 a.m. PDT",3619,3424,3667,48
NEVP,"3/25/2022 12 p.m. PDT",3687,3471,3638,-49
NEVP,"3/25/2022 1 p.m. PDT",3776,3524,3308,-468
NEVP,"3/25/2022 2 p.m. PDT",3905,3627,3270,-635
NEVP,"3/25/2022 3 p.m. PDT",4064,3768,3427,-637
NEVP,"3/25/2022 4 p.m. PDT",4234,3918,3727,-507
NEVP,"3/25/2022 5 p.m. PDT",4416,4139,3921,-495
NEVP,"3/25/2022 6 p.m. PDT",4489,4212,3682,-807
NEVP,"3/25/2022 7 p.m. PDT",4449,4253,3415,-1034
NEVP,"3/25/2022 8 p.m. PDT",4483,4253,3294,-1189
NEVP,"3/25/2022 9 p.m. PDT",4385,4183,3236,-1149
NEVP,"3/25/2022 10 p.m. PDT",4228,4010,3111,-1117
NEVP,"3/25/2022 11 p.m. PDT",4000,3768,3168,-832
NEVP,"3/26/2022 12 a.m. PDT",3782,3542,2923,-859
NEVP,"3/26/2022 1 a.m. PDT",3574,3357,2588,-986
NEVP,"3/26/2022 2 a.m. PDT",3425,3253,2487,-938
NEVP,"3/26/2022 3 a.m. PDT",3298,3223,2512,-786
NEVP,"3/26/2022 4 a.m. PDT",3234,3123,2452,-782
NEVP,"3/26/2022 5 a.m. PDT",3204,3123,2450,-754
NEVP,"3/26/2022 6 a.m. PDT",3227,3178,2444,-783
NEVP,"3/26/2022 7 a.m. PDT",3264,3231,2398,-866
NEVP,"3/26/2022 8 a.m. PDT",3274,3482,2566,-708
NEVP,"3/26/2022 9 a.m. PDT",3357,3465,2861,-496
NEVP,"3/26/2022 10 a.m. PDT",3446,3452,3117,-329
NEVP,"3/26/2022 11 a.m. PDT",3556,3434,3234,-322
NEVP,"3/26/2022 12 p.m. PDT",3647,3423,3244,-403
NEVP,"3/26/2022 1 p.m. PDT",3791,3418,3418,-373
NEVP,"3/26/2022 2 p.m. PDT",3948,3453,3345,-603
NEVP,"3/26/2022 3 p.m. PDT",4161,3518,3479,-682
NEVP,"3/26/2022 4 p.m. PDT",4383,3646,3484,-899
NEVP,"3/26/2022 5 p.m. PDT",4536,3753,3721,-815
NEVP,"3/26/2022 6 p.m. PDT",4602,3855,3500,-1102
NEVP,"3/26/2022 7 p.m. PDT",4552,3936,3213,-1339
NEVP,"3/26/2022 8 p.m. PDT",4527,3997,3203,-1324
NEVP,"3/26/2022 9 p.m. PDT",4399,3960,3359,-1040
NEVP,"3/26/2022 10 p.m. PDT",4206,3793,2973,-1233
NEVP,"3/26/2022 11 p.m. PDT",4002,3569,2906,-1096
NEVP,"3/27/2022 12 a.m. PDT",3759,3386,2756,-1003
NEVP,"3/27/2022 1 a.m. PDT",3554,3267,2791,-763
NEVP,"3/27/2022 2 a.m. PDT",3400,3160,2677,-723
NEVP,"3/27/2022 3 a.m. PDT",3288,3110,2614,-674
NEVP,"3/27/2022 4 a.m. PDT",3218,3078,2520,-698
NEVP,"3/27/2022 5 a.m. PDT",3197,3075,2589,-608
NEVP,"3/27/2022 6 a.m. PDT",3210,3131,2583,-627
NEVP,"3/27/2022 7 a.m. PDT",3233,3190,2528,-705
NEVP,"3/27/2022 8 a.m. PDT",3227,3213,2536,-691
NEVP,"3/27/2022 9 a.m. PDT",3333,3219,2842,-491
NEVP,"3/27/2022 10 a.m. PDT",3408,3295,2829,-579
NEVP,"3/27/2022 11 a.m. PDT",3475,3346,3250,-225
NEVP,"3/27/2022 12 p.m. PDT",3590,3448,3373,-217
NEVP,"3/27/2022 1 p.m. PDT",3731,3561,3501,-230
NEVP,"3/27/2022 2 p.m. PDT",3934,3662,3569,-365
NEVP,"3/27/2022 3 p.m. PDT",4012,3755,3684,-328
NEVP,"3/27/2022 4 p.m. PDT",4157,3872,3720,-437
NEVP,"3/27/2022 5 p.m. PDT",4303,3999,3853,-450
NEVP,"3/27/2022 6 p.m. PDT",4384,4100,3446,-938
NEVP,"3/27/2022 7 p.m. PDT",4375,4217,3246,-1129
NEVP,"3/27/2022 8 p.m. PDT",4393,4172,3110,-1283
NEVP,"3/27/2022 9 p.m. PDT",4298,4102,3234,-1064
NEVP,"3/27/2022 10 p.m. PDT",4092,3971,3121,-971
NEVP,"3/27/2022 11 p.m. PDT",3864,3715,3049,-815
NEVP,"3/28/2022 12 a.m. PDT",3641,3467,2801,-840
NEVP,"3/28/2022 1 a.m. PDT",3452,3255,2813,-639
NEVP,"3/28/2022 2 a.m. PDT",3337,3143,2527,-810
NEVP,"3/28/2022 3 a.m. PDT",3265,3079,2512,-753
NEVP,"3/28/2022 4 a.m. PDT",3245,3055,2529,-716
NEVP,"3/28/2022 5 a.m. PDT",3281,3104,2640,-641
NEVP,"3/28/2022 6 a.m. PDT",3404,3239,2618,-786
NEVP,"3/28/2022 7 a.m. PDT",3589,3431,2759,-830
NEVP,"3/28/2022 8 a.m. PDT",3640,3445,3043,-597
NEVP,"3/28/2022 9 a.m. PDT",3721,3425,3095,-626
NEVP,"3/28/2022 10 a.m. PDT",3686,3448,3534,-152
NEVP,"3/28/2022 11 a.m. PDT",3654,3443,4022,368
NEVP,"3/28/2022 12 p.m. PDT",3651,3452,3917,266
NEVP,"3/28/2022 1 p.m. PDT",3645,3419,3535,-110
NEVP,"3/28/2022 2 p.m. PDT",3767,3449,3463,-304
NEVP,"3/28/2022 3 p.m. PDT",3868,3486,3650,-218
NEVP,"3/28/2022 4 p.m. PDT",3973,3493,3596,-377
NEVP,"3/28/2022 5 p.m. PDT",4070,3505,3373,-697
NEVP,"3/28/2022 6 p.m. PDT",4082,3604,3121,-961
NEVP,"3/28/2022 7 p.m. PDT",4052,3692,3293,-759
NEVP,"3/28/2022 8 p.m. PDT",4103,3827,3373,-730
NEVP,"3/28/2022 9 p.m. PDT",4021,3794,3356,-665
NEVP,"3/28/2022 10 p.m. PDT",3855,3687,3150,-705
NEVP,"3/28/2022 11 p.m. PDT",3662,3484,3044,-618
NEVP,"3/29/2022 12 a.m. PDT",3467,3311,2857,-610
NEVP,"3/29/2022 1 a.m. PDT",3338,3179,2846,-492
NEVP,"3/29/2022 2 a.m. PDT",3244,3116,2779,-465
NEVP,"3/29/2022 3 a.m. PDT",3188,3069,2688,-500
NEVP,"3/29/2022 4 a.m. PDT",3183,3072,2586,-597
NEVP,"3/29/2022 5 a.m. PDT",3273,3128,2655,-618
NEVP,"3/29/2022 6 a.m. PDT",3393,3233,2706,-687
NEVP,"3/29/2022 7 a.m. PDT",3594,3406,2705,-889
NEVP,"3/29/2022 8 a.m. PDT",3602,3458,2941,-661
NEVP,"3/29/2022 9 a.m. PDT",3541,3473,2882,-659
NEVP,"3/29/2022 10 a.m. PDT",3540,3452,2524,-1016
NEVP,"3/29/2022 11 a.m. PDT",3601,3417,2565,-1036
NEVP,"3/29/2022 12 p.m. PDT",3570,3412,2688,-882
NEVP,"3/29/2022 1 p.m. PDT",3535,3394,2748,-787
NEVP,"3/29/2022 2 p.m. PDT",3538,3424,2708,-830
NEVP,"3/29/2022 3 p.m. PDT",3568,3448,2940,-628
NEVP,"3/29/2022 4 p.m. PDT",3665,3491,2985,-680
NEVP,"3/29/2022 5 p.m. PDT",3800,3668,3338,-462
NEVP,"3/29/2022 6 p.m. PDT",3905,3738,3022,-883
NEVP,"3/29/2022 7 p.m. PDT",3953,3777,2900,-1053
NEVP,"3/29/2022 8 p.m. PDT",4108,3908,3187,-921
NEVP,"3/29/2022 9 p.m. PDT",4083,3854,3204,-879
NEVP,"3/29/2022 10 p.m. PDT",3920,3767,3354,-566
NEVP,"3/29/2022 11 p.m. PDT",3709,3568,3216,-493
NEVP,"3/30/2022 12 a.m. PDT",3510,3395,3108,-402
NEVP,"3/30/2022 1 a.m. PDT",3354,3290,2979,-375
NEVP,"3/30/2022 2 a.m. PDT",3273,3196,2778,-495
NEVP,"3/30/2022 3 a.m. PDT",3291,3121,2784,-507
NEVP,"3/30/2022 4 a.m. PDT",3252,3150,2722,-530
NEVP,"3/30/2022 5 a.m. PDT",3250,3183,2677,-573
NEVP,"3/30/2022 6 a.m. PDT",3396,3328,2755,-641
NEVP,"3/30/2022 7 a.m. PDT",3599,3488,2879,-720
NEVP,"3/30/2022 8 a.m. PDT",3622,3476,3356,-266
NEVP,"3/30/2022 9 a.m. PDT",3663,3435,3588,-75
NEVP,"3/30/2022 10 a.m. PDT",3664,3443,3464,-200
NEVP,"3/30/2022 11 a.m. PDT",3624,3417,3377,-247
NEVP,"3/30/2022 12 p.m. PDT",3619,3395,3392,-227
NEVP,"3/30/2022 1 p.m. PDT",3647,3412,3254,-393
NEVP,"3/30/2022 2 p.m. PDT",3659,3457,3387,-272
NEVP,"3/30/2022 3 p.m. PDT",3763,3516,3313,-450
NEVP,"3/30/2022 4 p.m. PDT",3911,3684,3312,-599
NEVP,"3/30/2022 5 p.m. PDT",4016,3708,3143,-873
NEVP,"3/30/2022 6 p.m. PDT",4056,3883,3007,-1049
NEVP,"3/30/2022 7 p.m. PDT",4110,3925,3008,-1102
NEVP,"3/30/2022 8 p.m. PDT",4231,4016,3403,-828
NEVP,"3/30/2022 9 p.m. PDT",4201,3985,3412,-789
NEVP,"3/30/2022 10 p.m. PDT",4032,3875,3210,-822
NEVP,"3/30/2022 11 p.m. PDT",3812,3655,3025,-787
NEVP,"3/31/2022 12 a.m. PDT",3602,3471,2905,-697
NEVP,"3/31/2022 1 a.m. PDT",3434,3261,2739,-695
NEVP,"3/31/2022 2 a.m. PDT",3335,3141,2546,-789
NEVP,"3/31/2022 3 a.m. PDT",3273,3073,2610,-663
NEVP,"3/31/2022 4 a.m. PDT",3227,3083,2671,-556
NEVP,"3/31/2022 5 a.m. PDT",3270,3114,2806,-464
NEVP,"3/31/2022 6 a.m. PDT",3392,3281,2821,-571
NEVP,"3/31/2022 7 a.m. PDT",3532,3466,2847,-685
NEVP,"3/31/2022 8 a.m. PDT",3590,3577,2961,-629
NEVP,"3/31/2022 9 a.m. PDT",3673,3519,3505,-168
NEVP,"3/31/2022 10 a.m. PDT",3683,3433,3570,-113
NEVP,"3/31/2022 11 a.m. PDT",3559,3388,3362,-197
NEVP,"3/31/2022 12 p.m. PDT",3578,3370,3466,-112
NEVP,"3/31/2022 1 p.m. PDT",3615,3396,3403,-212
NEVP,"3/31/2022 2 p.m. PDT",3680,3453,3261,-419
NEVP,"3/31/2022 3 p.m. PDT",3836,3572,3184,-652
NEVP,"3/31/2022 4 p.m. PDT",3905,3694,3346,-559
NEVP,"3/31/2022 5 p.m. PDT",4060,3842,3553,-507
NEVP,"3/31/2022 6 p.m. PDT",4160,3960,3372,-788
NEVP,"3/31/2022 7 p.m. PDT",4162,4045,2995,-1167
NEVP,"3/31/2022 8 p.m. PDT",4284,4138,3107,-1177
NEVP,"3/31/2022 9 p.m. PDT",4205,4054,3419,-786
NEVP,"3/31/2022 10 p.m. PDT",4076,3904,3450,-626
NEVP,"3/31/2022 11 p.m. PDT",3847,3703,3335,-512
NEVP,"4/1/2022 12 a.m. PDT",3599,3506,3023,-576
