"BA Code","Timestamp (Hour Ending)","Demand (MWh)","Demand Forecast (MWh)","Net Generation (MWh)","Total Interchange (MWh)"
NEVP,"4/1/2022 12 a.m. PDT",3599,3506,3023,-576
NEVP,"4/1/2022 1 a.m. PDT",3437,3288,2736,-701
NEVP,"4/1/2022 2 a.m. PDT",3341,3175,2673,-668
NEVP,"4/1/2022 3 a.m. PDT",3264,3112,2610,-654
NEVP,"4/1/2022 4 a.m. PDT",3250,3122,2330,-920
NEVP,"4/1/2022 5 a.m. PDT",3286,3132,2343,-943
NEVP,"4/1/2022 6 a.m. PDT",3447,3301,2496,-951
NEVP,"4/1/2022 7 a.m. PDT",3606,3440,2613,-993
NEVP,"4/1/2022 8 a.m. PDT",3652,3430,3425,-227
NEVP,"4/1/2022 9 a.m. PDT",3664,3439,3518,-146
NEVP,"4/1/2022 10 a.m. PDT",3629,3465,3278,-351
NEVP,"4/1/2022 11 a.m. PDT",3664,3412,3248,-416
NEVP,"4/1/2022 12 p.m. PDT",3675,3437,3362,-313
NEVP,"4/1/2022 1 p.m. PDT",3705,3456,3357,-348
NEVP,"4/1/2022 2 p.m. PDT",3765,3479,3322,-443
NEVP,"4/1/2022 3 p.m. PDT",3880,3589,3356,-524
NEVP,"4/1/2022 4 p.m. PDT",4018,3750,3450,-568
NEVP,"4/1/2022 5 p.m. PDT",4176,3915,3608,-568
NEVP,"4/1/2022 6 p.m. PDT",4280,3969,3342,-938
NEVP,"4/1/2022 7 p.m. PDT",4287,4034,3089,-1198
NEVP,"4/1/2022 8 p.m. PDT",4324,4064,2986,-1338
NEVP,"4/1/2022 9 p.m. PDT",4258,4038,3064,-1194
NEVP,"4/1/2022 10 p.m. PDT",4081,3905,3099,-982
NEVP,"4/1/2022 11 p.m. PDT",3860,3679,2992,-868
NEVP,"4/2/2022 12 a.m. PDT",3663,3480,2783,-880
NEVP,"4/2/2022 1 a.m. PDT",3481,3325,2499,-982
NEVP,"4/2/2022 2 a.m. PDT",3401,3207,2663,-738
NEVP,"4/2/2022 3 a.m. PDT",3345,3115,2497,-848
NEVP,"4/2/2022 4 a.m. PDT",3278,3098,2404,-874
NEVP,"4/2/2022 5 a.m. PDT",3247,3072,2421,-826
NEVP,"4/2/2022 6 a.m. PDT",3321,3140,2444,-877
NEVP,"4/2/2022 7 a.m. PDT",3307,3261,2517,-790
NEVP,"4/2/2022 8 a.m. PDT",3321,3246,2997,-324
NEVP,"4/2/2022 9 a.m. PDT",3384,3280,3412,28
NEVP,"4/2/2022 10 a.m. PDT",3484,3320,3442,-42
NEVP,"4/2/2022 11 a.m. PDT",3536,3328,3473,-63
NEVP,"4/2/2022 12 p.m. PDT",3599,3361,3460,-139
NEVP,"4/2/2022 1 p.m. PDT",3728,3381,3437,-291
NEVP,"4/2/2022 2 p.m. PDT",3792,3441,3462,-330
NEVP,"4/2/2022 3 p.m. PDT",3921,3552,3594,-327
NEVP,"4/2/2022 4 p.m. PDT",4091,3699,3753,-338
NEVP,"4/2/2022 5 p.m. PDT",4259,3781,3725,-534
NEVP,"4/2/2022 6 p.m. PDT",4316,3864,3378,-938
NEVP,"4/2/2022 7 p.m. PDT",4288,3928,3019,-1269
NEVP,"4/2/2022 8 p.m. PDT",4333,3970,3140,-1193
NEVP,"4/2/2022 9 p.m. PDT",4243,3940,3346,-897
NEVP,"4/2/2022 10 p.m. PDT",4111,3819,3282,-829
NEVP,"4/2/2022 11 p.m. PDT",3914,3661,3186,-728
NEVP,"4/3/2022 12 a.m. PDT",3711,3467,3110,-601
NEVP,"4/3/2022 1 a.m. PDT",3526,3285,2798,-728
NEVP,"4/3/2022 2 a.m. PDT",3391,3165,2701,-690
NEVP,"4/3/2022 3 a.m. PDT",3308,3123,2564,-744
NEVP,"4/3/2022 4 a.m. PDT",3236,3122,2519,-717
NEVP,"4/3/2022 5 a.m. PDT",3227,3123,2439,-788
NEVP,"4/3/2022 6 a.m. PDT",3249,3191,2420,-829
NEVP,"4/3/2022 7 a.m. PDT",3239,3209,2390,-849
NEVP,"4/3/2022 8 a.m. PDT",3222,3246,2694,-528
NEVP,"4/3/2022 9 a.m. PDT",3308,3280,2982,-326
NEVP,"4/3/2022 10 a.m. PDT",3393,3320,3331,-62
NEVP,"4/3/2022 11 a.m. PDT",3489,3328,3288,-201
NEVP,"4/3/2022 12 p.m. PDT",3526,3361,3107,-419
NEVP,"4/3/2022 1 p.m. PDT",3648,3381,3245,-403
NEVP,"4/3/2022 2 p.m. PDT",3753,3441,3237,-516
NEVP,"4/3/2022 3 p.m. PDT",3851,3552,3251,-600
NEVP,"4/3/2022 4 p.m. PDT",3967,3699,2969,-998
NEVP,"4/3/2022 5 p.m. PDT",4084,3781,2835,-1249
NEVP,"4/3/2022 6 p.m. PDT",4173,3864,3069,-1104
NEVP,"4/3/2022 7 p.m. PDT",4224,3928,2953,-1271
NEVP,"4/3/2022 8 p.m. PDT",4313,3970,2934,-1379
NEVP,"4/3/2022 9 p.m. PDT",4282,3940,3092,-1190
NEVP,"4/3/2022 10 p.m. PDT",4109,3819,3008,-1101
NEVP,"4/3/2022 11 p.m. PDT",3875,3661,3031,-844
NEVP,"4/4/2022 12 a.m. PDT",3640,3467,3021,-619
NEVP,"4/4/2022 1 a.m. PDT",3460,3212,2643,-817
NEVP,"4/4/2022 2 a.m. PDT",3285,3120,2386,-899
NEVP,"4/4/2022 3 a.m. PDT",3159,3061,2401,-758
NEVP,"4/4/2022 4 a.m. PDT",3238,3092,2559,-679
NEVP,"4/4/2022 5 a.m. PDT",3301,3088,2591,-710
NEVP,"4/4/2022 6 a.m. PDT",3429,3233,2950,-479
NEVP,"4/4/2022 7 a.m. PDT",3555,3367,2961,-594
NEVP,"4/4/2022 8 a.m. PDT",3553,3384,3226,-327
NEVP,"4/4/2022 9 a.m. PDT",3593,3366,3303,-290
NEVP,"4/4/2022 10 a.m. PDT",3650,3350,3129,-521
NEVP,"4/4/2022 11 a.m. PDT",3769,3375,3056,-713
NEVP,"4/4/2022 12 p.m. PDT",3831,3352,3060,-771
NEVP,"4/4/2022 1 p.m. PDT",3966,3424,3105,-861
NEVP,"4/4/2022 2 p.m. PDT",3995,3423,3112,-883
NEVP,"4/4/2022 3 p.m. PDT",4124,3461,3301,-823
NEVP,"4/4/2022 4 p.m. PDT",4309,3522,3670,-639
NEVP,"4/4/2022 5 p.m. PDT",4496,3592,3676,-820
NEVP,"4/4/2022 6 p.m. PDT",4502,3762,3359,-1143
NEVP,"4/4/2022 7 p.m. PDT",4666,3846,3668,-998
NEVP,"4/4/2022 8 p.m. PDT",4517,3912,3630,-887
NEVP,"4/4/2022 9 p.m. PDT",4460,3877,3515,-945
NEVP,"4/4/2022 10 p.m. PDT",4269,3760,3328,-941
NEVP,"4/4/2022 11 p.m. PDT",4005,3528,3017,-988
NEVP,"4/5/2022 12 a.m. PDT",3776,3373,2880,-896
NEVP,"4/5/2022 1 a.m. PDT",3564,3307,2806,-758
NEVP,"4/5/2022 2 a.m. PDT",3442,3165,2793,-649
NEVP,"4/5/2022 3 a.m. PDT",3343,3072,2649,-694
NEVP,"4/5/2022 4 a.m. PDT",3303,3033,2653,-650
NEVP,"4/5/2022 5 a.m. PDT",3326,3013,2646,-680
NEVP,"4/5/2022 6 a.m. PDT",3432,3095,2701,-731
NEVP,"4/5/2022 7 a.m. PDT",3546,3238,2955,-591
NEVP,"4/5/2022 8 a.m. PDT",3589,3468,2983,-606
NEVP,"4/5/2022 9 a.m. PDT",3651,3566,3152,-499
NEVP,"4/5/2022 10 a.m. PDT",3728,3602,3181,-547
NEVP,"4/5/2022 11 a.m. PDT",3772,3632,3222,-550
NEVP,"4/5/2022 12 p.m. PDT",3849,3711,3312,-537
NEVP,"4/5/2022 1 p.m. PDT",3990,3900,3425,-565
NEVP,"4/5/2022 2 p.m. PDT",4141,4118,3490,-651
NEVP,"4/5/2022 3 p.m. PDT",4306,4382,3592,-714
NEVP,"4/5/2022 4 p.m. PDT",4499,4486,3727,-772
NEVP,"4/5/2022 5 p.m. PDT",4651,4718,3977,-674
NEVP,"4/5/2022 6 p.m. PDT",4715,4795,3934,-781
NEVP,"4/5/2022 7 p.m. PDT",4681,4760,3470,-1211
NEVP,"4/5/2022 8 p.m. PDT",4679,4671,3280,-1399
NEVP,"4/5/2022 9 p.m. PDT",4618,4523,3435,-1183
NEVP,"4/5/2022 10 p.m. PDT",4391,4258,3434,-957
NEVP,"4/5/2022 11 p.m. PDT",4111,3974,3395,-716
NEVP,"4/6/2022 12 a.m. PDT",3875,3706,3410,-465
NEVP,"4/6/2022 1 a.m. PDT",3648,3368,3282,-366
NEVP,"4/6/2022 2 a.m. PDT",3471,3223,3087,-384
NEVP,"4/6/2022 3 a.m. PDT",3369,3102,3085,-284
NEVP,"4/6/2022 4 a.m. PDT",3326,3069,3102,-224
NEVP,"4/6/2022 5 a.m. PDT",3340,3116,3086,-254
NEVP,"4/6/2022 6 a.m. PDT",3459,3225,3085,-374
NEVP,"4/6/2022 7 a.m. PDT",3589,3379,3069,-520
NEVP,"4/6/2022 8 a.m. PDT",3604,3455,3048,-556
NEVP,"4/6/2022 9 a.m. PDT",3591,3492,3330,-261
NEVP,"4/6/2022 10 a.m. PDT",3562,3507,3304,-258
NEVP,"4/6/2022 11 a.m. PDT",3555,3532,3368,-187
NEVP,"4/6/2022 12 p.m. PDT",3600,3561,3381,-219
NEVP,"4/6/2022 1 p.m. PDT",3533,3605,3251,-282
NEVP,"4/6/2022 2 p.m. PDT",3609,3688,3242,-367
NEVP,"4/6/2022 3 p.m. PDT",3723,3791,3252,-471
NEVP,"4/6/2022 4 p.m. PDT",3842,3959,3366,-476
NEVP,"4/6/2022 5 p.m. PDT",3995,4182,3675,-320
NEVP,"4/6/2022 6 p.m. PDT",4100,4155,3618,-482
NEVP,"4/6/2022 7 p.m. PDT",4171,4193,3547,-624
NEVP,"4/6/2022 8 p.m. PDT",4256,4177,3399,-857
NEVP,"4/6/2022 9 p.m. PDT",4244,4097,3375,-869
NEVP,"4/6/2022 10 p.m. PDT",4060,3906,3271,-789
NEVP,"4/6/2022 11 p.m. PDT",3812,3710,3054,-758
NEVP,"4/7/2022 12 a.m. PDT",3585,3527,2905,-680
NEVP,"4/7/2022 1 a.m. PDT",3405,3335,2888,-517
NEVP,"4/7/2022 2 a.m. PDT",3311,3243,2777,-534
NEVP,"4/7/2022 3 a.m. PDT",3242,3190,2740,-502
NEVP,"4/7/2022 4 a.m. PDT",3217,3174,2710,-507
NEVP,"4/7/2022 5 a.m. PDT",3259,3217,2631,-628
NEVP,"4/7/2022 6 a.m. PDT",3388,3318,2654,-734
NEVP,"4/7/2022 7 a.m. PDT",3520,3421,2897,-623
NEVP,"4/7/2022 8 a.m. PDT",3557,3441,3335,-222
NEVP,"4/7/2022 9 a.m. PDT",3578,3498,3028,-550
NEVP,"4/7/2022 10 a.m. PDT",3599,3498,3087,-512
NEVP,"4/7/2022 11 a.m. PDT",3584,3560,3116,-468
NEVP,"4/7/2022 12 p.m. PDT",3590,3558,3073,-517
NEVP,"4/7/2022 1 p.m. PDT",3653,3626,3044,-609
NEVP,"4/7/2022 2 p.m. PDT",3742,3701,3079,-663
NEVP,"4/7/2022 3 p.m. PDT",3890,3972,3192,-698
NEVP,"4/7/2022 4 p.m. PDT",4087,4149,3469,-618
NEVP,"4/7/2022 5 p.m. PDT",4289,4356,4270,-19
NEVP,"4/7/2022 6 p.m. PDT",4408,4587,4038,-370
NEVP,"4/7/2022 7 p.m. PDT",4469,4579,3731,-738
NEVP,"4/7/2022 8 p.m. PDT",4480,4522,3728,-752
NEVP,"4/7/2022 9 p.m. PDT",4395,4398,3648,-747
NEVP,"4/7/2022 10 p.m. PDT",4165,4212,3565,-600
NEVP,"4/7/2022 11 p.m. PDT",3903,3957,3014,-889
NEVP,"4/8/2022 12 a.m. PDT",3650,3701,2858,-792
NEVP,"4/8/2022 1 a.m. PDT",3450,3350,2832,-618
NEVP,"4/8/2022 2 a.m. PDT",3333,3266,2755,-578
NEVP,"4/8/2022 3 a.m. PDT",3260,3174,2735,-525
NEVP,"4/8/2022 4 a.m. PDT",3226,3162,2587,-639
NEVP,"4/8/2022 5 a.m. PDT",3258,3147,2584,-674
NEVP,"4/8/2022 6 a.m. PDT",3381,3246,2604,-777
NEVP,"4/8/2022 7 a.m. PDT",3501,3368,2690,-811
NEVP,"4/8/2022 8 a.m. PDT",3548,3456,2921,-627
NEVP,"4/8/2022 9 a.m. PDT",3639,3491,3063,-576
NEVP,"4/8/2022 10 a.m. PDT",3699,3555,3114,-585
NEVP,"4/8/2022 11 a.m. PDT",3747,3607,3121,-626
NEVP,"4/8/2022 12 p.m. PDT",3786,3678,3202,-584
NEVP,"4/8/2022 1 p.m. PDT",3897,3844,3465,-432
NEVP,"4/8/2022 2 p.m. PDT",4036,4004,3757,-279
NEVP,"4/8/2022 3 p.m. PDT",4231,4296,4058,-173
NEVP,"4/8/2022 4 p.m. PDT",4480,4464,4037,-443
NEVP,"4/8/2022 5 p.m. PDT",4669,4548,4382,-287
NEVP,"4/8/2022 6 p.m. PDT",4778,4656,4366,-412
NEVP,"4/8/2022 7 p.m. PDT",4764,4653,4092,-672
NEVP,"4/8/2022 8 p.m. PDT",4691,4565,3786,-905
NEVP,"4/8/2022 9 p.m. PDT",4573,4440,3814,-759
NEVP,"4/8/2022 10 p.m. PDT",4342,4198,3727,-615
NEVP,"4/8/2022 11 p.m. PDT",4061,3944,3358,-703
NEVP,"4/9/2022 12 a.m. PDT",3804,3734,3238,-566
NEVP,"4/9/2022 1 a.m. PDT",3591,3446,2818,-773
NEVP,"4/9/2022 2 a.m. PDT",3436,3326,2632,-804
NEVP,"4/9/2022 3 a.m. PDT",3356,3237,2638,-718
NEVP,"4/9/2022 4 a.m. PDT",3338,3179,2633,-705
NEVP,"4/9/2022 5 a.m. PDT",3317,3148,2648,-669
NEVP,"4/9/2022 6 a.m. PDT",3352,3265,2620,-732
NEVP,"4/9/2022 7 a.m. PDT",3360,3283,2880,-480
NEVP,"4/9/2022 8 a.m. PDT",3392,3277,2856,-536
NEVP,"4/9/2022 9 a.m. PDT",3504,3367,2772,-732
NEVP,"4/9/2022 10 a.m. PDT",3533,3466,3198,-335
NEVP,"4/9/2022 11 a.m. PDT",3609,3627,3195,-414
NEVP,"4/9/2022 12 p.m. PDT",3742,3762,3372,-370
NEVP,"4/9/2022 1 p.m. PDT",3876,3934,3578,-298
NEVP,"4/9/2022 2 p.m. PDT",4082,4042,3698,-384
NEVP,"4/9/2022 3 p.m. PDT",4320,4295,3845,-475
NEVP,"4/9/2022 4 p.m. PDT",4542,4419,3908,-634
NEVP,"4/9/2022 5 p.m. PDT",4705,4525,4221,-484
NEVP,"4/9/2022 6 p.m. PDT",4771,4555,4062,-709
NEVP,"4/9/2022 7 p.m. PDT",4733,4615,3503,-1230
NEVP,"4/9/2022 8 p.m. PDT",4686,4557,3508,-1178
NEVP,"4/9/2022 9 p.m. PDT",4555,4348,3468,-1087
NEVP,"4/9/2022 10 p.m. PDT",4409,4117,3305,-1104
NEVP,"4/9/2022 11 p.m. PDT",4100,3939,2947,-1153
NEVP,"4/10/2022 12 a.m. PDT",3916,3666,2986,-930
NEVP,"4/10/2022 1 a.m. PDT",3708,3480,2730,-978
NEVP,"4/10/2022 2 a.m. PDT",3557,3345,2516,-1041
NEVP,"4/10/2022 3 a.m. PDT",3439,3269,2478,-961
NEVP,"4/10/2022 4 a.m. PDT",3352,3245,2484,-868
NEVP,"4/10/2022 5 a.m. PDT",3318,3218,2593,-725
NEVP,"4/10/2022 6 a.m. PDT",3308,3223,2778,-530
NEVP,"4/10/2022 7 a.m. PDT",3290,3232,2849,-441
NEVP,"4/10/2022 8 a.m. PDT",3273,3220,2857,-416
NEVP,"4/10/2022 9 a.m. PDT",3332,3248,3061,-271
NEVP,"4/10/2022 10 a.m. PDT",3380,3266,3241,-139
NEVP,"4/10/2022 11 a.m. PDT",3326,3267,3520,194
NEVP,"4/10/2022 12 p.m. PDT",3355,3285,3466,111
NEVP,"4/10/2022 1 p.m. PDT",3368,3340,3354,-14
NEVP,"4/10/2022 2 p.m. PDT",3427,3354,3379,-48
NEVP,"4/10/2022 3 p.m. PDT",3548,3522,3409,-139
NEVP,"4/10/2022 4 p.m. PDT",3700,3627,3302,-398
NEVP,"4/10/2022 5 p.m. PDT",3861,3724,3494,-367
NEVP,"4/10/2022 6 p.m. PDT",3925,3872,3107,-818
NEVP,"4/10/2022 7 p.m. PDT",3981,3978,3211,-770
NEVP,"4/10/2022 8 p.m. PDT",4036,4069,3214,-822
NEVP,"4/10/2022 9 p.m. PDT",4034,4016,3330,-704
NEVP,"4/10/2022 10 p.m. PDT",3890,3879,3316,-574
NEVP,"4/10/2022 11 p.m. PDT",3688,3707,3299,-389
NEVP,"4/11/2022 12 a.m. PDT",3492,3460,2951,-541
NEVP,"4/11/2022 1 a.m. PDT",3341,3318,2738,-603
NEVP,"4/11/2022 2 a.m. PDT",3249,3218,2640,-609
NEVP,"4/11/2022 3 a.m. PDT",3190,3166,2468,-722
NEVP,"4/11/2022 4 a.m. PDT",3177,3156,2584,-593
NEVP,"4/11/2022 5 a.m. PDT",3230,3192,2546,-684
NEVP,"4/11/2022 6 a.m. PDT",3363,3329,2732,-631
NEVP,"4/11/2022 7 a.m. PDT",3461,3450,2984,-477
NEVP,"4/11/2022 8 a.m. PDT",3497,3489,3367,-130
NEVP,"4/11/2022 9 a.m. PDT",3557,3494,3437,-120
NEVP,"4/11/2022 10 a.m. PDT",3570,3517,3238,-332
NEVP,"4/11/2022 11 a.m. PDT",3601,3532,3128,-473
NEVP,"4/11/2022 12 p.m. PDT",3610,3534,3083,-527
NEVP,"4/11/2022 1 p.m. PDT",3637,3593,3064,-573
NEVP,"4/11/2022 2 p.m. PDT",3698,3701,2863,-835
NEVP,"4/11/2022 3 p.m. PDT",3819,3810,2707,-1112
NEVP,"4/11/2022 4 p.m. PDT",3882,3984,2983,-899
NEVP,"4/11/2022 5 p.m. PDT",3940,4172,3196,-744
NEVP,"4/11/2022 6 p.m. PDT",3991,4238,3077,-914
NEVP,"4/11/2022 7 p.m. PDT",4050,4304,3238,-812
NEVP,"4/11/2022 8 p.m. PDT",4159,4322,3598,-561
NEVP,"4/11/2022 9 p.m. PDT",4140,4254,3646,-494
NEVP,"4/11/2022 10 p.m. PDT",3970,4112,3367,-603
NEVP,"4/11/2022 11 p.m. PDT",3753,3863,3138,-615
NEVP,"4/12/2022 12 a.m. PDT",3560,3618,3002,-558
NEVP,"4/12/2022 1 a.m. PDT",3403,3312,2723,-680
NEVP,"4/12/2022 2 a.m. PDT",3304,3266,2736,-568
NEVP,"4/12/2022 3 a.m. PDT",3248,3193,2752,-496
NEVP,"4/12/2022 4 a.m. PDT",3238,3253,2739,-499
NEVP,"4/12/2022 5 a.m. PDT",3299,3295,2785,-514
NEVP,"4/12/2022 6 a.m. PDT",3423,3446,2882,-541
NEVP,"4/12/2022 7 a.m. PDT",3527,3533,3337,-190
NEVP,"4/12/2022 8 a.m. PDT",3544,3595,3358,-186
NEVP,"4/12/2022 9 a.m. PDT",3539,3596,3387,-152
NEVP,"4/12/2022 10 a.m. PDT",3504,3516,3264,-240
NEVP,"4/12/2022 11 a.m. PDT",3457,3522,3228,-229
NEVP,"4/12/2022 12 p.m. PDT",3458,3435,3213,-245
NEVP,"4/12/2022 1 p.m. PDT",3421,3430,3247,-174
NEVP,"4/12/2022 2 p.m. PDT",3372,3402,3225,-147
NEVP,"4/12/2022 3 p.m. PDT",3383,3422,3209,-174
NEVP,"4/12/2022 4 p.m. PDT",3477,3454,3174,-303
NEVP,"4/12/2022 5 p.m. PDT",3575,3518,3416,-159
NEVP,"4/12/2022 6 p.m. PDT",3657,3594,3458,-199
NEVP,"4/12/2022 7 p.m. PDT",3791,3868,3051,-740
NEVP,"4/12/2022 8 p.m. PDT",3987,3979,3326,-661
NEVP,"4/12/2022 9 p.m. PDT",4008,3984,3503,-505
NEVP,"4/12/2022 10 p.m. PDT",3894,3790,3342,-552
NEVP,"4/12/2022 11 p.m. PDT",3708,3668,3266,-442
NEVP,"4/13/2022 12 a.m. PDT",3547,3463,3261,-286
NEVP,"4/13/2022 1 a.m. PDT",3420,3323,3241,-179
NEVP,"4/13/2022 2 a.m. PDT",3349,3241,3152,-197
NEVP,"4/13/2022 3 a.m. PDT",3311,3140,2981,-330
NEVP,"4/13/2022 4 a.m. PDT",3311,3146,2901,-410
NEVP,"4/13/2022 5 a.m. PDT",3364,3177,3002,-362
NEVP,"4/13/2022 6 a.m. PDT",3505,3292,3131,-374
NEVP,"4/13/2022 7 a.m. PDT",3588,3366,3361,-227
NEVP,"4/13/2022 8 a.m. PDT",3603,3431,3595,-8
NEVP,"4/13/2022 9 a.m. PDT",3579,3400,3385,-194
NEVP,"4/13/2022 10 a.m. PDT",3525,3390,3172,-353
NEVP,"4/13/2022 11 a.m. PDT",3471,3369,3223,-248
NEVP,"4/13/2022 12 p.m. PDT",3435,3468,3261,-174
NEVP,"4/13/2022 1 p.m. PDT",3421,3532,3340,-81
NEVP,"4/13/2022 2 p.m. PDT",3444,3606,3273,-171
NEVP,"4/13/2022 3 p.m. PDT",3470,3715,3285,-185
NEVP,"4/13/2022 4 p.m. PDT",3522,3818,3307,-215
NEVP,"4/13/2022 5 p.m. PDT",3607,3905,3322,-285
NEVP,"4/13/2022 6 p.m. PDT",3717,3946,3176,-541
NEVP,"4/13/2022 7 p.m. PDT",3820,3984,3032,-788
NEVP,"4/13/2022 8 p.m. PDT",3976,4037,3436,-540
NEVP,"4/13/2022 9 p.m. PDT",3999,4012,3546,-453
NEVP,"4/13/2022 10 p.m. PDT",3885,3856,3481,-404
NEVP,"4/13/2022 11 p.m. PDT",3695,3666,3384,-311
NEVP,"4/14/2022 12 a.m. PDT",3522,3471,3373,-149
NEVP,"4/14/2022 1 a.m. PDT",3383,3230,3147,-236
NEVP,"4/14/2022 2 a.m. PDT",3309,3136,2999,-310
NEVP,"4/14/2022 3 a.m. PDT",3261,3087,2862,-399
NEVP,"4/14/2022 4 a.m. PDT",3247,3067,2807,-440
NEVP,"4/14/2022 5 a.m. PDT",3285,3117,2868,-417
NEVP,"4/14/2022 6 a.m. PDT",3417,3257,3159,-258
NEVP,"4/14/2022 7 a.m. PDT",3501,3355,3457,-44
NEVP,"4/14/2022 8 a.m. PDT",3515,3488,3610,95
NEVP,"4/14/2022 9 a.m. PDT",3499,3471,3654,155
NEVP,"4/14/2022 10 a.m. PDT",3470,3435,3167,-303
NEVP,"4/14/2022 11 a.m. PDT",3486,3374,3000,-486
NEVP,"4/14/2022 12 p.m. PDT",3475,3409,3181,-294
NEVP,"4/14/2022 1 p.m. PDT",3480,3383,3213,-267
NEVP,"4/14/2022 2 p.m. PDT",3510,3467,3141,-369
NEVP,"4/14/2022 3 p.m. PDT",3572,3608,3128,-444
NEVP,"4/14/2022 4 p.m. PDT",3683,3662,3197,-486
NEVP,"4/14/2022 5 p.m. PDT",3808,3722,3202,-606
NEVP,"4/14/2022 6 p.m. PDT",3931,3901,3160,-771
NEVP,"4/14/2022 7 p.m. PDT",4003,3942,3095,-908
NEVP,"4/14/2022 8 p.m. PDT",4115,4074,3564,-551
NEVP,"4/14/2022 9 p.m. PDT",4085,4020,3418,-667
NEVP,"4/14/2022 10 p.m. PDT",3990,3905,3420,-570
NEVP,"4/14/2022 11 p.m. PDT",3793,3693,3266,-527
NEVP,"4/15/2022 12 a.m. PDT",3596,3508,3220,-376
NEVP,"4/15/2022 1 a.m. PDT",3438,3219,3134,-304
NEVP,"4/15/2022 2 a.m. PDT",3329,3139,2918,-411
NEVP,"4/15/2022 3 a.m. PDT",3262,3075,2885,-377
NEVP,"4/15/2022 4 a.m. PDT",3232,3047,2883,-349
NEVP,"4/15/2022 5 a.m. PDT",3256,3093,2866,-390
NEVP,"4/15/2022 6 a.m. PDT",3342,3209,2868,-474
NEVP,"4/15/2022 7 a.m. PDT",3389,3406,2915,-474
NEVP,"4/15/2022 8 a.m. PDT",3421,3380,3053,-368
NEVP,"4/15/2022 9 a.m. PDT",3449,3417,3138,-311
NEVP,"4/15/2022 10 a.m. PDT",3457,3442,3254,-203
NEVP,"4/15/2022 11 a.m. PDT",3484,3448,3291,-193
NEVP,"4/15/2022 12 p.m. PDT",3500,3453,3287,-213
NEVP,"4/15/2022 1 p.m. PDT",3547,3465,3278,-269
NEVP,"4/15/2022 2 p.m. PDT",3629,3481,3260,-369
NEVP,"4/15/2022 3 p.m. PDT",3740,3527,3329,-411
NEVP,"4/15/2022 4 p.m. PDT",3888,3612,3322,-566
NEVP,"4/15/2022 5 p.m. PDT",4042,3712,3560,-482
NEVP,"4/15/2022 6 p.m. PDT",4105,3800,3518,-587
NEVP,"4/15/2022 7 p.m. PDT",4134,3876,3258,-876
NEVP,"4/15/2022 8 p.m. PDT",4228,3998,3207,-1021
NEVP,"4/15/2022 9 p.m. PDT",4173,3988,3289,-884
NEVP,"4/15/2022 10 p.m. PDT",4015,3901,3294,-721
NEVP,"4/15/2022 11 p.m. PDT",3826,3715,3166,-660
NEVP,"4/16/2022 12 a.m. PDT",3637,3533,3104,-533
NEVP,"4/16/2022 1 a.m. PDT",3481,3245,2915,-566
NEVP,"4/16/2022 2 a.m. PDT",3344,3153,2846,-498
NEVP,"4/16/2022 3 a.m. PDT",3271,3088,2744,-527
NEVP,"4/16/2022 4 a.m. PDT",3226,3079,2633,-593
NEVP,"4/16/2022 5 a.m. PDT",3232,3097,2654,-578
NEVP,"4/16/2022 6 a.m. PDT",3274,3137,2738,-536
NEVP,"4/16/2022 7 a.m. PDT",3260,3164,2873,-387
NEVP,"4/16/2022 8 a.m. PDT",3277,3108,2766,-511
NEVP,"4/16/2022 9 a.m. PDT",3351,3163,2894,-457
NEVP,"4/16/2022 10 a.m. PDT",3439,3284,3231,-208
NEVP,"4/16/2022 11 a.m. PDT",3482,3273,3418,-64
NEVP,"4/16/2022 12 p.m. PDT",3521,3287,3501,-20
NEVP,"4/16/2022 1 p.m. PDT",3557,3317,3437,-120
NEVP,"4/16/2022 2 p.m. PDT",3579,3343,3447,-132
NEVP,"4/16/2022 3 p.m. PDT",3623,3351,3370,-253
NEVP,"4/16/2022 4 p.m. PDT",3735,3454,3198,-537
NEVP,"4/16/2022 5 p.m. PDT",3860,3578,3223,-637
NEVP,"4/16/2022 6 p.m. PDT",3952,3674,3236,-716
NEVP,"4/16/2022 7 p.m. PDT",3983,3863,2642,-1341
NEVP,"4/16/2022 8 p.m. PDT",4053,3910,2730,-1323
NEVP,"4/16/2022 9 p.m. PDT",4049,3849,2999,-1050
NEVP,"4/16/2022 10 p.m. PDT",3930,3753,3085,-845
NEVP,"4/16/2022 11 p.m. PDT",3772,3603,3113,-659
NEVP,"4/17/2022 12 a.m. PDT",3594,3430,3072,-522
NEVP,"4/17/2022 1 a.m. PDT",3435,3327,2770,-665
NEVP,"4/17/2022 2 a.m. PDT",3318,3203,2674,-644
NEVP,"4/17/2022 3 a.m. PDT",3237,3137,2531,-706
NEVP,"4/17/2022 4 a.m. PDT",3182,3151,2449,-733
NEVP,"4/17/2022 5 a.m. PDT",3175,3094,2472,-703
NEVP,"4/17/2022 6 a.m. PDT",3192,3136,2600,-592
NEVP,"4/17/2022 7 a.m. PDT",3166,3110,2705,-461
NEVP,"4/17/2022 8 a.m. PDT",3165,3103,2917,-248
NEVP,"4/17/2022 9 a.m. PDT",3197,3149,3261,64
NEVP,"4/17/2022 10 a.m. PDT",3267,3259,3418,151
NEVP,"4/17/2022 11 a.m. PDT",3335,3259,3517,182
NEVP,"4/17/2022 12 p.m. PDT",3407,3321,3475,68
NEVP,"4/17/2022 1 p.m. PDT",3512,3430,3430,-82
NEVP,"4/17/2022 2 p.m. PDT",3633,3488,3406,-227
NEVP,"4/17/2022 3 p.m. PDT",3768,3679,3449,-319
NEVP,"4/17/2022 4 p.m. PDT",3978,3834,3533,-445
NEVP,"4/17/2022 5 p.m. PDT",4185,3991,3666,-519
NEVP,"4/17/2022 6 p.m. PDT",4311,4087,3564,-747
NEVP,"4/17/2022 7 p.m. PDT",4320,4110,3427,-893
NEVP,"4/17/2022 8 p.m. PDT",4287,4151,3424,-863
NEVP,"4/17/2022 9 p.m. PDT",4247,4063,3470,-777
NEVP,"4/17/2022 10 p.m. PDT",4056,3889,3500,-556
NEVP,"4/17/2022 11 p.m. PDT",3834,3664,3409,-425
NEVP,"4/18/2022 12 a.m. PDT",3592,3464,3310,-282
NEVP,"4/18/2022 1 a.m. PDT",3415,3336,2934,-481
NEVP,"4/18/2022 2 a.m. PDT",3293,3241,2871,-422
NEVP,"4/18/2022 3 a.m. PDT",3216,3165,2778,-438
NEVP,"4/18/2022 4 a.m. PDT",3186,3161,2767,-419
NEVP,"4/18/2022 5 a.m. PDT",3223,3150,2772,-451
NEVP,"4/18/2022 6 a.m. PDT",3328,3260,2847,-481
NEVP,"4/18/2022 7 a.m. PDT",3394,3365,2929,-465
NEVP,"4/18/2022 8 a.m. PDT",3449,3414,3579,130
NEVP,"4/18/2022 9 a.m. PDT",3527,3435,3369,-158
NEVP,"4/18/2022 10 a.m. PDT",3605,3504,3271,-334
NEVP,"4/18/2022 11 a.m. PDT",3752,3558,3383,-369
NEVP,"4/18/2022 12 p.m. PDT",3796,3652,3596,-200
NEVP,"4/18/2022 1 p.m. PDT",3923,3775,3496,-427
NEVP,"4/18/2022 2 p.m. PDT",4109,3803,3596,-513
NEVP,"4/18/2022 3 p.m. PDT",4290,4085,3765,-525
NEVP,"4/18/2022 4 p.m. PDT",4530,4352,3724,-806
NEVP,"4/18/2022 5 p.m. PDT",4573,4456,4190,-383
NEVP,"4/18/2022 6 p.m. PDT",4644,4512,4495,-149
NEVP,"4/18/2022 7 p.m. PDT",4691,4498,4266,-425
NEVP,"4/18/2022 8 p.m. PDT",4720,4484,3949,-771
NEVP,"4/18/2022 9 p.m. PDT",4692,4371,3878,-814
NEVP,"4/18/2022 10 p.m. PDT",4498,4143,3732,-766
NEVP,"4/18/2022 11 p.m. PDT",4214,3850,3599,-615
NEVP,"4/19/2022 12 a.m. PDT",3947,3626,3316,-631
NEVP,"4/19/2022 1 a.m. PDT",3759,3496,3028,-731
NEVP,"4/19/2022 2 a.m. PDT",3600,3369,2885,-715
NEVP,"4/19/2022 3 a.m. PDT",3492,3311,2879,-613
NEVP,"4/19/2022 4 a.m. PDT",3438,3221,2904,-534
NEVP,"4/19/2022 5 a.m. PDT",3458,3186,2872,-586
NEVP,"4/19/2022 6 a.m. PDT",3564,3276,2896,-668
NEVP,"4/19/2022 7 a.m. PDT",3623,3381,3131,-492
NEVP,"4/19/2022 8 a.m. PDT",3721,3417,3601,-120
NEVP,"4/19/2022 9 a.m. PDT",3832,3449,3512,-320
NEVP,"4/19/2022 10 a.m. PDT",3929,3520,3671,-258
NEVP,"4/19/2022 11 a.m. PDT",4032,3562,3618,-414
NEVP,"4/19/2022 12 p.m. PDT",4117,3646,3493,-624
NEVP,"4/19/2022 1 p.m. PDT",4229,3729,3360,-869
NEVP,"4/19/2022 2 p.m. PDT",4262,3892,3297,-965
NEVP,"4/19/2022 3 p.m. PDT",4393,4054,3623,-770
NEVP,"4/19/2022 4 p.m. PDT",4494,4236,3698,-796
NEVP,"4/19/2022 5 p.m. PDT",4547,4394,4031,-516
NEVP,"4/19/2022 6 p.m. PDT",4589,4486,4298,-291
NEVP,"4/19/2022 7 p.m. PDT",4580,4532,3969,-611
NEVP,"4/19/2022 8 p.m. PDT",4565,4459,3839,-726
NEVP,"4/19/2022 9 p.m. PDT",4507,4352,3931,-576
NEVP,"4/19/2022 10 p.m. PDT",4304,4151,3830,-474
NEVP,"4/19/2022 11 p.m. PDT",4028,3818,3471,-557
NEVP,"4/20/2022 12 a.m. PDT",3781,3561,3246,-535
NEVP,"4/20/2022 1 a.m. PDT",3587,3381,3020,-567
NEVP,"4/20/2022 2 a.m. PDT",3452,3258,2960,-492
NEVP,"4/20/2022 3 a.m. PDT",3369,3174,2871,-498
NEVP,"4/20/2022 4 a.m. PDT",3323,3181,2838,-485
NEVP,"4/20/2022 5 a.m. PDT",3340,3189,2836,-504
NEVP,"4/20/2022 6 a.m. PDT",3453,3306,3073,-380
NEVP,"4/20/2022 7 a.m. PDT",3523,3379,3377,-146
NEVP,"4/20/2022 8 a.m. PDT",3574,3372,3505,-69
NEVP,"4/20/2022 9 a.m. PDT",3605,3374,3367,-238
NEVP,"4/20/2022 10 a.m. PDT",3692,3425,3445,-247
NEVP,"4/20/2022 11 a.m. PDT",3751,3490,3408,-343
NEVP,"4/20/2022 12 p.m. PDT",3834,3535,3425,-409
NEVP,"4/20/2022 1 p.m. PDT",3893,3568,3432,-461
NEVP,"4/20/2022 2 p.m. PDT",4018,3647,3476,-542
NEVP,"4/20/2022 3 p.m. PDT",4175,3872,3405,-770
NEVP,"4/20/2022 4 p.m. PDT",4360,4076,3651,-709
NEVP,"4/20/2022 5 p.m. PDT",4560,4199,3916,-644
NEVP,"4/20/2022 6 p.m. PDT",4628,4221,4198,-430
NEVP,"4/20/2022 7 p.m. PDT",4624,4246,4022,-602
NEVP,"4/20/2022 8 p.m. PDT",4617,4273,3908,-709
NEVP,"4/20/2022 9 p.m. PDT",4590,4209,4160,-430
NEVP,"4/20/2022 10 p.m. PDT",4392,4052,3822,-570
NEVP,"4/20/2022 11 p.m. PDT",4114,3849,3599,-515
NEVP,"4/21/2022 12 a.m. PDT",3857,3650,3263,-594
NEVP,"4/21/2022 1 a.m. PDT",3648,3274,2963,-685
NEVP,"4/21/2022 2 a.m. PDT",3500,3141,2837,-663
NEVP,"4/21/2022 3 a.m. PDT",3432,3075,2689,-743
NEVP,"4/21/2022 4 a.m. PDT",3391,3044,2631,-760
NEVP,"4/21/2022 5 a.m. PDT",3420,3085,2661,-759
NEVP,"4/21/2022 6 a.m. PDT",3515,3271,2792,-723
NEVP,"4/21/2022 7 a.m. PDT",3613,3319,3053,-560
NEVP,"4/21/2022 8 a.m. PDT",3676,3376,3386,-290
NEVP,"4/21/2022 9 a.m. PDT",3759,3405,3109,-650
NEVP,"4/21/2022 10 a.m. PDT",3802,3411,3149,-653
NEVP,"4/21/2022 11 a.m. PDT",3850,3418,3268,-582
NEVP,"4/21/2022 12 p.m. PDT",3869,3428,3326,-543
NEVP,"4/21/2022 1 p.m. PDT",3900,3486,3347,-553
NEVP,"4/21/2022 2 p.m. PDT",3973,3577,3347,-626
NEVP,"4/21/2022 3 p.m. PDT",4077,3672,3397,-680
NEVP,"4/21/2022 4 p.m. PDT",4241,3831,3640,-601
NEVP,"4/21/2022 5 p.m. PDT",4406,3940,3842,-564
NEVP,"4/21/2022 6 p.m. PDT",4481,4058,4261,-220
NEVP,"4/21/2022 7 p.m. PDT",4499,4088,3923,-576
NEVP,"4/21/2022 8 p.m. PDT",4505,4149,3762,-743
NEVP,"4/21/2022 9 p.m. PDT",4425,4057,3647,-778
NEVP,"4/21/2022 10 p.m. PDT",4254,3902,3581,-673
NEVP,"4/21/2022 11 p.m. PDT",3989,3692,3427,-562
NEVP,"4/22/2022 12 a.m. PDT",3775,3430,3243,-532
NEVP,"4/22/2022 1 a.m. PDT",3571,3243,3088,-483
NEVP,"4/22/2022 2 a.m. PDT",3455,3128,3026,-429
NEVP,"4/22/2022 3 a.m. PDT",3365,3072,2982,-383
NEVP,"4/22/2022 4 a.m. PDT",3335,3044,3025,-310
NEVP,"4/22/2022 5 a.m. PDT",3349,3081,3044,-305
NEVP,"4/22/2022 6 a.m. PDT",3471,3174,3013,-458
NEVP,"4/22/2022 7 a.m. PDT",3558,3312,3034,-524
NEVP,"4/22/2022 8 a.m. PDT",3546,3335,3069,-477
NEVP,"4/22/2022 9 a.m. PDT",3607,3364,2862,-745
NEVP,"4/22/2022 10 a.m. PDT",3670,3354,2748,-922
NEVP,"4/22/2022 11 a.m. PDT",3797,3355,2611,-1186
NEVP,"4/22/2022 12 p.m. PDT",3912,3342,2522,-1390
NEVP,"4/22/2022 1 p.m. PDT",3782,3399,2483,-1299
NEVP,"4/22/2022 2 p.m. PDT",3539,3501,2892,-647
NEVP,"4/22/2022 3 p.m. PDT",3509,3600,3306,-203
NEVP,"4/22/2022 4 p.m. PDT",3591,3689,3289,-302
NEVP,"4/22/2022 5 p.m. PDT",3701,3792,3269,-432
NEVP,"4/22/2022 6 p.m. PDT",3830,3925,3089,-741
NEVP,"4/22/2022 7 p.m. PDT",3847,3951,3300,-547
NEVP,"4/22/2022 8 p.m. PDT",3960,3911,3352,-608
NEVP,"4/22/2022 9 p.m. PDT",4040,3856,3335,-705
NEVP,"4/22/2022 10 p.m. PDT",3922,3730,3349,-573
NEVP,"4/22/2022 11 p.m. PDT",3763,3566,3280,-483
NEVP,"4/23/2022 12 a.m. PDT",3596,3423,3080,-516
NEVP,"4/23/2022 1 a.m. PDT",3450,3284,2925,-525
NEVP,"4/23/2022 2 a.m. PDT",3372,3163,2884,-488
NEVP,"4/23/2022 3 a.m. PDT",3308,3105,2789,-519
NEVP,"4/23/2022 4 a.m. PDT",3267,3074,2784,-483
NEVP,"4/23/2022 5 a.m. PDT",3276,3110,2840,-436
NEVP,"4/23/2022 6 a.m. PDT",3317,3212,3028,-289
NEVP,"4/23/2022 7 a.m. PDT",3297,3298,3115,-182
NEVP,"4/23/2022 8 a.m. PDT",3298,3341,3261,-37
NEVP,"4/23/2022 9 a.m. PDT",3317,3370,3531,214
NEVP,"4/23/2022 10 a.m. PDT",3314,3360,3402,88
NEVP,"4/23/2022 11 a.m. PDT",3340,3361,3375,35
NEVP,"4/23/2022 12 p.m. PDT",3361,3348,3375,14
NEVP,"4/23/2022 1 p.m. PDT",3372,3461,3457,85
NEVP,"4/23/2022 2 p.m. PDT",3400,3582,3460,60
NEVP,"4/23/2022 3 p.m. PDT",3454,3705,3466,12
NEVP,"4/23/2022 4 p.m. PDT",3543,3850,3422,-121
NEVP,"4/23/2022 5 p.m. PDT",3698,3973,3504,-194
NEVP,"4/23/2022 6 p.m. PDT",3817,4064,3339,-478
NEVP,"4/23/2022 7 p.m. PDT",3880,4087,2961,-919
NEVP,"4/23/2022 8 p.m. PDT",3955,4077,3095,-860
NEVP,"4/23/2022 9 p.m. PDT",3974,4017,3056,-918
NEVP,"4/23/2022 10 p.m. PDT",3878,3844,3138,-740
NEVP,"4/23/2022 11 p.m. PDT",3716,3631,3201,-515
NEVP,"4/24/2022 12 a.m. PDT",3550,3447,3153,-397
NEVP,"4/24/2022 1 a.m. PDT",3447,3284,3045,-402
NEVP,"4/24/2022 2 a.m. PDT",3327,3163,3076,-251
NEVP,"4/24/2022 3 a.m. PDT",3259,3105,3164,-95
NEVP,"4/24/2022 4 a.m. PDT",3234,3074,3193,-41
NEVP,"4/24/2022 5 a.m. PDT",3226,3110,2840,-386
NEVP,"4/24/2022 6 a.m. PDT",3268,3212,2805,-463
NEVP,"4/24/2022 7 a.m. PDT",3219,3298,2982,-237
NEVP,"4/24/2022 8 a.m. PDT",3206,3341,3435,229
NEVP,"4/24/2022 9 a.m. PDT",3229,3370,3224,-5
NEVP,"4/24/2022 10 a.m. PDT",3249,3360,3304,55
NEVP,"4/24/2022 11 a.m. PDT",3304,3361,3368,64
NEVP,"4/24/2022 12 p.m. PDT",3323,3348,3368,45
NEVP,"4/24/2022 1 p.m. PDT",3350,3461,3363,13
NEVP,"4/24/2022 2 p.m. PDT",3407,3582,3361,-46
NEVP,"4/24/2022 3 p.m. PDT",3490,3705,3347,-143
NEVP,"4/24/2022 4 p.m. PDT",3613,3850,3277,-336
NEVP,"4/24/2022 5 p.m. PDT",3766,3973,3343,-423
NEVP,"4/24/2022 6 p.m. PDT",3904,4064,3472,-432
NEVP,"4/24/2022 7 p.m. PDT",3956,4087,3034,-922
NEVP,"4/24/2022 8 p.m. PDT",4034,4077,2897,-1137
NEVP,"4/24/2022 9 p.m. PDT",4078,4017,3115,-963
NEVP,"4/24/2022 10 p.m. PDT",3912,3844,3314,-598
NEVP,"4/24/2022 11 p.m. PDT",3725,3631,3328,-397
NEVP,"4/25/2022 12 a.m. PDT",3519,3447,3140,-379
NEVP,"4/25/2022 1 a.m. PDT",3367,3284,2901,-466
NEVP,"4/25/2022 2 a.m. PDT",3279,3165,2741,-538
NEVP,"4/25/2022 3 a.m. PDT",3212,3110,2765,-447
NEVP,"4/25/2022 4 a.m. PDT",3213,3067,2759,-454
NEVP,"4/25/2022 5 a.m. PDT",3274,3101,3013,-261
NEVP,"4/25/2022 6 a.m. PDT",3389,3206,3001,-388
NEVP,"4/25/2022 7 a.m. PDT",3477,3296,3353,-124
NEVP,"4/25/2022 8 a.m. PDT",3537,3335,4034,497
NEVP,"4/25/2022 9 a.m. PDT",3557,3379,3981,424
NEVP,"4/25/2022 10 a.m. PDT",3581,3401,3757,176
NEVP,"4/25/2022 11 a.m. PDT",3629,3468,3774,145
NEVP,"4/25/2022 12 p.m. PDT",3659,3515,3760,101
NEVP,"4/25/2022 1 p.m. PDT",3705,3695,3832,127
NEVP,"4/25/2022 2 p.m. PDT",3774,3848,4296,522
NEVP,"4/25/2022 3 p.m. PDT",3930,4043,4441,511
NEVP,"4/25/2022 4 p.m. PDT",4014,4153,4371,357
NEVP,"4/25/2022 5 p.m. PDT",4192,4230,4538,346
NEVP,"4/25/2022 6 p.m. PDT",4320,4302,4378,58
NEVP,"4/25/2022 7 p.m. PDT",4365,4309,3606,-759
NEVP,"4/25/2022 8 p.m. PDT",4386,4239,3564,-822
NEVP,"4/25/2022 9 p.m. PDT",4372,4152,3533,-839
NEVP,"4/25/2022 10 p.m. PDT",4150,3979,3544,-606
NEVP,"4/25/2022 11 p.m. PDT",3879,3680,3433,-446
NEVP,"4/26/2022 12 a.m. PDT",3650,3511,3295,-355
NEVP,"4/26/2022 1 a.m. PDT",3475,3284,3153,-322
NEVP,"4/26/2022 2 a.m. PDT",3366,3165,2924,-442
NEVP,"4/26/2022 3 a.m. PDT",3298,3110,2807,-491
NEVP,"4/26/2022 4 a.m. PDT",3268,3067,2789,-479
NEVP,"4/26/2022 5 a.m. PDT",3309,3101,2752,-557
NEVP,"4/26/2022 6 a.m. PDT",3427,3206,2812,-615
NEVP,"4/26/2022 7 a.m. PDT",3503,3296,2969,-534
NEVP,"4/26/2022 8 a.m. PDT",3547,3335,3646,99
NEVP,"4/26/2022 9 a.m. PDT",3576,3379,3873,297
NEVP,"4/26/2022 10 a.m. PDT",3642,3401,3792,150
NEVP,"4/26/2022 11 a.m. PDT",3735,3468,3875,140
NEVP,"4/26/2022 12 p.m. PDT",3848,3515,3486,-362
NEVP,"4/26/2022 1 p.m. PDT",4000,3695,3328,-672
NEVP,"4/26/2022 2 p.m. PDT",4047,3848,3309,-738
NEVP,"4/26/2022 3 p.m. PDT",4221,4043,3636,-585
NEVP,"4/26/2022 4 p.m. PDT",4430,4153,3912,-518
NEVP,"4/26/2022 5 p.m. PDT",4561,4230,4312,-249
NEVP,"4/26/2022 6 p.m. PDT",4629,4302,4359,-270
NEVP,"4/26/2022 7 p.m. PDT",4660,4309,4218,-442
NEVP,"4/26/2022 8 p.m. PDT",4666,4239,4050,-616
NEVP,"4/26/2022 9 p.m. PDT",4633,4152,4189,-444
NEVP,"4/26/2022 10 p.m. PDT",4414,3979,3988,-426
NEVP,"4/26/2022 11 p.m. PDT",4124,3680,3701,-423
NEVP,"4/27/2022 12 a.m. PDT",3846,3511,3475,-371
NEVP,"4/27/2022 1 a.m. PDT",3648,3520,3473,-175
NEVP,"4/27/2022 2 a.m. PDT",3530,3300,3405,-125
NEVP,"4/27/2022 3 a.m. PDT",3451,3200,3311,-140
NEVP,"4/27/2022 4 a.m. PDT",3417,3176,3169,-248
NEVP,"4/27/2022 5 a.m. PDT",3431,3129,2886,-545
NEVP,"4/27/2022 6 a.m. PDT",3527,3266,2761,-766
NEVP,"4/27/2022 7 a.m. PDT",3603,3301,3131,-472
NEVP,"4/27/2022 8 a.m. PDT",3695,3359,3910,215
NEVP,"4/27/2022 9 a.m. PDT",3782,3430,3749,-33
NEVP,"4/27/2022 10 a.m. PDT",3889,3512,3603,-286
NEVP,"4/27/2022 11 a.m. PDT",4022,3628,3625,-397
NEVP,"4/27/2022 12 p.m. PDT",4136,3690,3630,-506
NEVP,"4/27/2022 1 p.m. PDT",4285,3847,3641,-644
NEVP,"4/27/2022 2 p.m. PDT",4408,4001,3644,-764
NEVP,"4/27/2022 3 p.m. PDT",4570,4229,3814,-756
NEVP,"4/27/2022 4 p.m. PDT",4759,4337,4151,-608
NEVP,"4/27/2022 5 p.m. PDT",4884,4438,4477,-407
NEVP,"4/27/2022 6 p.m. PDT",4939,4536,4886,-53
NEVP,"4/27/2022 7 p.m. PDT",4876,4510,4314,-562
NEVP,"4/27/2022 8 p.m. PDT",4838,4466,4068,-770
NEVP,"4/27/2022 9 p.m. PDT",4805,4326,4223,-582
NEVP,"4/27/2022 10 p.m. PDT",4547,4106,4063,-484
NEVP,"4/27/2022 11 p.m. PDT",4304,3859,3980,-324
NEVP,"4/28/2022 12 a.m. PDT",4018,3596,3840,-178
NEVP,"4/28/2022 1 a.m. PDT",3767,3397,3485,-282
NEVP,"4/28/2022 2 a.m. PDT",3622,3280,3315,-307
NEVP,"4/28/2022 3 a.m. PDT",3511,3188,2812,-699
NEVP,"4/28/2022 4 a.m. PDT",3455,3133,2747,-708
NEVP,"4/28/2022 5 a.m. PDT",3462,3167,2741,-721
NEVP,"4/28/2022 6 a.m. PDT",3559,3192,2869,-690
NEVP,"4/28/2022 7 a.m. PDT",3643,3287,3051,-592
NEVP,"4/28/2022 8 a.m. PDT",3707,3406,3204,-503
NEVP,"4/28/2022 9 a.m. PDT",3750,3417,2990,-760
NEVP,"4/28/2022 10 a.m. PDT",3703,3459,3385,-318
NEVP,"4/28/2022 11 a.m. PDT",3847,3522,3575,-272
NEVP,"4/28/2022 12 p.m. PDT",3906,3629,3682,-224
NEVP,"4/28/2022 1 p.m. PDT",3995,3680,3767,-228
NEVP,"4/28/2022 2 p.m. PDT",4047,3748,3764,-283
NEVP,"4/28/2022 3 p.m. PDT",4148,3914,3725,-423
NEVP,"4/28/2022 4 p.m. PDT",4261,4020,3853,-408
NEVP,"4/28/2022 5 p.m. PDT",4410,4143,4053,-357
NEVP,"4/28/2022 6 p.m. PDT",4466,4182,3996,-470
NEVP,"4/28/2022 7 p.m. PDT",4448,4257,3635,-813
NEVP,"4/28/2022 8 p.m. PDT",4446,4288,3676,-770
NEVP,"4/28/2022 9 p.m. PDT",4438,4276,3806,-632
NEVP,"4/28/2022 10 p.m. PDT",4236,4113,3531,-705
NEVP,"4/28/2022 11 p.m. PDT",3985,3879,3297,-688
NEVP,"4/29/2022 12 a.m. PDT",3749,3671,3237,-512
NEVP,"4/29/2022 1 a.m. PDT",3570,3400,3108,-462
NEVP,"4/29/2022 2 a.m. PDT",3461,3295,3097,-364
NEVP,"4/29/2022 3 a.m. PDT",3385,3220,2965,-420
NEVP,"4/29/2022 4 a.m. PDT",3359,3217,2945,-414
NEVP,"4/29/2022 5 a.m. PDT",3379,3249,2905,-474
NEVP,"4/29/2022 6 a.m. PDT",3482,3317,2848,-634
NEVP,"4/29/2022 7 a.m. PDT",3550,3364,3088,-462
NEVP,"4/29/2022 8 a.m. PDT",3617,3439,3399,-218
NEVP,"4/29/2022 9 a.m. PDT",3655,3460,3462,-193
NEVP,"4/29/2022 10 a.m. PDT",3702,3509,3408,-294
NEVP,"4/29/2022 11 a.m. PDT",3726,3544,3459,-267
NEVP,"4/29/2022 12 p.m. PDT",3770,3615,3586,-184
NEVP,"4/29/2022 1 p.m. PDT",3815,3723,3537,-278
NEVP,"4/29/2022 2 p.m. PDT",3889,3751,3630,-259
NEVP,"4/29/2022 3 p.m. PDT",4036,3904,3617,-419
NEVP,"4/29/2022 4 p.m. PDT",4245,4110,3789,-456
NEVP,"4/29/2022 5 p.m. PDT",4420,4259,3917,-503
NEVP,"4/29/2022 6 p.m. PDT",4541,4350,4040,-501
NEVP,"4/29/2022 7 p.m. PDT",4561,4315,3960,-601
NEVP,"4/29/2022 8 p.m. PDT",4523,4265,3747,-776
NEVP,"4/29/2022 9 p.m. PDT",4479,4292,3670,-809
NEVP,"4/29/2022 10 p.m. PDT",4295,4073,3606,-689
NEVP,"4/29/2022 11 p.m. PDT",4056,3889,3427,-629
NEVP,"4/30/2022 12 a.m. PDT",3815,3640,3240,-575
NEVP,"4/30/2022 1 a.m. PDT",3604,3424,3031,-573
NEVP,"4/30/2022 2 a.m. PDT",3466,3312,2989,-477
NEVP,"4/30/2022 3 a.m. PDT",3365,3235,2814,-551
NEVP,"4/30/2022 4 a.m. PDT",3314,3211,2702,-612
NEVP,"4/30/2022 5 a.m. PDT",3303,3161,2713,-590
NEVP,"4/30/2022 6 a.m. PDT",3323,3208,2741,-582
NEVP,"4/30/2022 7 a.m. PDT",3289,3232,2735,-554
NEVP,"4/30/2022 8 a.m. PDT",3333,3135,3080,-253
NEVP,"4/30/2022 9 a.m. PDT",3449,3196,3297,-152
NEVP,"4/30/2022 10 a.m. PDT",3534,3245,3461,-73
NEVP,"4/30/2022 11 a.m. PDT",3620,3366,3427,-193
NEVP,"4/30/2022 12 p.m. PDT",3728,3444,3337,-391
NEVP,"4/30/2022 1 p.m. PDT",3842,3620,3395,-447
NEVP,"4/30/2022 2 p.m. PDT",3988,3769,3511,-477
NEVP,"4/30/2022 3 p.m. PDT",4214,4072,3546,-668
NEVP,"4/30/2022 4 p.m. PDT",4461,4330,3713,-748
NEVP,"4/30/2022 5 p.m. PDT",4707,4497,3943,-764
NEVP,"4/30/2022 6 p.m. PDT",4839,4537,3807,-1032
NEVP,"4/30/2022 7 p.m. PDT",4826,4564,3776,-1050
NEVP,"4/30/2022 8 p.m. PDT",4709,4395,3787,-922
NEVP,"4/30/2022 9 p.m. PDT",4614,4332,3756,-858
NEVP,"4/30/2022 10 p.m. PDT",4412,4115,3493,-919
NEVP,"4/30/2022 11 p.m. PDT",4205,3941,3396,-809
NEVP,"5/1/2022 12 a.m. PDT",3984,3649,3303,-681
