"BA Code","Timestamp (Hour Ending)","Demand (MWh)","Demand Forecast (MWh)","Net Generation (MWh)","Total Interchange (MWh)"
NEVP,"8/1/2022 12 a.m. PDT",5246,5662,4165,-1081
NEVP,"8/1/2022 1 a.m. PDT",4923,5347,4116,-807
NEVP,"8/1/2022 2 a.m. PDT",4723,5078,4138,-585
NEVP,"8/1/2022 3 a.m. PDT",4588,4925,3888,-700
NEVP,"8/1/2022 4 a.m. PDT",4488,4755,3740,-748
NEVP,"8/1/2022 5 a.m. PDT",4457,4627,3621,-836
NEVP,"8/1/2022 6 a.m. PDT",4492,4680,3797,-695
NEVP,"8/1/2022 7 a.m. PDT",4543,4653,3985,-558
NEVP,"8/1/2022 8 a.m. PDT",4830,4909,4559,-271
NEVP,"8/1/2022 9 a.m. PDT",5130,5220,4475,-655
NEVP,"8/1/2022 10 a.m. PDT",5434,5511,4466,-968
NEVP,"8/1/2022 11 a.m. PDT",5723,5910,4746,-977
NEVP,"8/1/2022 12 p.m. PDT",6077,6224,4832,-1245
NEVP,"8/1/2022 1 p.m. PDT",6435,6584,4827,-1608
NEVP,"8/1/2022 2 p.m. PDT",6742,7085,4671,-2071
NEVP,"8/1/2022 3 p.m. PDT",7096,7089,4852,-2244
NEVP,"8/1/2022 4 p.m. PDT",7122,7125,4692,-2430
NEVP,"8/1/2022 5 p.m. PDT",7023,6955,4650,-2373
NEVP,"8/1/2022 6 p.m. PDT",6765,6903,4813,-1952
NEVP,"8/1/2022 7 p.m. PDT",6536,6775,4738,-1798
NEVP,"8/1/2022 8 p.m. PDT",6360,6630,4281,-2079
NEVP,"8/1/2022 9 p.m. PDT",6256,6525,4186,-2070
NEVP,"8/1/2022 10 p.m. PDT",6036,6254,4038,-1998
NEVP,"8/1/2022 11 p.m. PDT",5717,5960,3876,-1841
NEVP,"8/2/2022 12 a.m. PDT",5387,5399,3958,-1429
NEVP,"8/2/2022 1 a.m. PDT",5093,4544,3784,-1309
NEVP,"8/2/2022 2 a.m. PDT",4881,4330,3533,-1348
NEVP,"8/2/2022 3 a.m. PDT",4708,4175,3695,-1013
NEVP,"8/2/2022 4 a.m. PDT",4598,4140,3777,-821
NEVP,"8/2/2022 5 a.m. PDT",4570,4202,3884,-686
NEVP,"8/2/2022 6 a.m. PDT",4599,4234,3726,-873
NEVP,"8/2/2022 7 a.m. PDT",4631,4296,3814,-817
NEVP,"8/2/2022 8 a.m. PDT",4954,4598,3844,-1110
NEVP,"8/2/2022 9 a.m. PDT",5379,4948,4025,-1354
NEVP,"8/2/2022 10 a.m. PDT",5745,5192,4123,-1622
NEVP,"8/2/2022 11 a.m. PDT",6138,5641,4584,-1554
NEVP,"8/2/2022 12 p.m. PDT",6502,5978,5050,-1452
NEVP,"8/2/2022 1 p.m. PDT",6886,6166,5091,-1795
NEVP,"8/2/2022 2 p.m. PDT",7270,6357,5254,-2016
NEVP,"8/2/2022 3 p.m. PDT",7544,6756,5382,-2162
NEVP,"8/2/2022 4 p.m. PDT",7698,6791,5844,-1854
NEVP,"8/2/2022 5 p.m. PDT",7817,7031,5944,-1873
NEVP,"8/2/2022 6 p.m. PDT",7840,6871,5893,-1947
NEVP,"8/2/2022 7 p.m. PDT",7623,6838,5473,-2150
NEVP,"8/2/2022 8 p.m. PDT",7400,6684,5227,-2173
NEVP,"8/2/2022 9 p.m. PDT",7230,6342,5033,-2197
NEVP,"8/2/2022 10 p.m. PDT",6877,6114,4735,-2142
NEVP,"8/2/2022 11 p.m. PDT",6420,5689,4841,-1579
NEVP,"8/3/2022 12 a.m. PDT",5982,5253,4751,-1231
NEVP,"8/3/2022 1 a.m. PDT",5513,5001,4459,-1054
NEVP,"8/3/2022 2 a.m. PDT",5226,4797,4011,-1215
NEVP,"8/3/2022 3 a.m. PDT",5029,4632,3770,-1259
NEVP,"8/3/2022 4 a.m. PDT",4896,4544,3629,-1267
NEVP,"8/3/2022 5 a.m. PDT",4830,4459,3573,-1257
NEVP,"8/3/2022 6 a.m. PDT",4839,4494,3633,-1206
NEVP,"8/3/2022 7 a.m. PDT",4820,4533,3499,-1321
NEVP,"8/3/2022 8 a.m. PDT",5035,4666,3810,-1225
NEVP,"8/3/2022 9 a.m. PDT",5336,4982,4044,-1292
NEVP,"8/3/2022 10 a.m. PDT",5656,5247,4443,-1213
NEVP,"8/3/2022 11 a.m. PDT",6137,5598,4822,-1315
NEVP,"8/3/2022 12 p.m. PDT",6583,5846,4932,-1651
NEVP,"8/3/2022 1 p.m. PDT",7025,6100,5287,-1738
NEVP,"8/3/2022 2 p.m. PDT",7434,6310,5585,-1849
NEVP,"8/3/2022 3 p.m. PDT",7819,6606,6005,-1814
NEVP,"8/3/2022 4 p.m. PDT",8105,6817,6014,-2091
NEVP,"8/3/2022 5 p.m. PDT",8319,6984,5981,-2338
NEVP,"8/3/2022 6 p.m. PDT",8373,6870,5479,-2894
NEVP,"8/3/2022 7 p.m. PDT",8258,6773,5072,-3186
NEVP,"8/3/2022 8 p.m. PDT",7913,6521,4721,-3192
NEVP,"8/3/2022 9 p.m. PDT",7580,6338,4686,-2894
NEVP,"8/3/2022 10 p.m. PDT",7150,6047,4504,-2646
NEVP,"8/3/2022 11 p.m. PDT",6668,5674,4320,-2348
NEVP,"8/4/2022 12 a.m. PDT",6210,5277,4271,-1939
NEVP,"8/4/2022 1 a.m. PDT",5789,5156,4268,-1521
NEVP,"8/4/2022 2 a.m. PDT",5471,5027,3992,-1479
NEVP,"8/4/2022 3 a.m. PDT",5262,4794,3547,-1715
NEVP,"8/4/2022 4 a.m. PDT",5122,4585,3383,-1739
NEVP,"8/4/2022 5 a.m. PDT",5055,4537,3576,-1479
NEVP,"8/4/2022 6 a.m. PDT",5067,4549,3728,-1339
NEVP,"8/4/2022 7 a.m. PDT",5072,4608,3491,-1581
NEVP,"8/4/2022 8 a.m. PDT",5286,4666,3682,-1604
NEVP,"8/4/2022 9 a.m. PDT",5627,4952,3655,-1972
NEVP,"8/4/2022 10 a.m. PDT",5899,5256,3771,-2128
NEVP,"8/4/2022 11 a.m. PDT",6018,5731,4144,-1874
NEVP,"8/4/2022 12 p.m. PDT",6162,6038,4771,-1391
NEVP,"8/4/2022 1 p.m. PDT",6319,6226,5147,-1172
NEVP,"8/4/2022 2 p.m. PDT",6511,6551,5458,-1053
NEVP,"8/4/2022 3 p.m. PDT",6647,6834,5386,-1261
NEVP,"8/4/2022 4 p.m. PDT",6654,6965,5147,-1507
NEVP,"8/4/2022 5 p.m. PDT",6545,6848,4553,-1992
NEVP,"8/4/2022 6 p.m. PDT",6361,6854,4210,-2151
NEVP,"8/4/2022 7 p.m. PDT",6218,6780,3896,-2322
NEVP,"8/4/2022 8 p.m. PDT",6106,6714,3971,-2135
NEVP,"8/4/2022 9 p.m. PDT",6023,6322,4119,-1904
NEVP,"8/4/2022 10 p.m. PDT",5827,6065,4251,-1576
NEVP,"8/4/2022 11 p.m. PDT",5527,5563,4392,-1135
NEVP,"8/5/2022 12 a.m. PDT",5239,5233,4317,-922
NEVP,"8/5/2022 1 a.m. PDT",4947,5402,4321,-626
NEVP,"8/5/2022 2 a.m. PDT",4774,5156,4273,-501
NEVP,"8/5/2022 3 a.m. PDT",4634,4931,4096,-538
NEVP,"8/5/2022 4 a.m. PDT",4562,4787,3664,-898
NEVP,"8/5/2022 5 a.m. PDT",4531,4722,3765,-766
NEVP,"8/5/2022 6 a.m. PDT",4589,4734,3832,-757
NEVP,"8/5/2022 7 a.m. PDT",4594,4767,3385,-1209
NEVP,"8/5/2022 8 a.m. PDT",4769,4544,3027,-1742
NEVP,"8/5/2022 9 a.m. PDT",5014,4771,3060,-1954
NEVP,"8/5/2022 10 a.m. PDT",5135,4978,3524,-1611
NEVP,"8/5/2022 11 a.m. PDT",5254,5291,3949,-1305
NEVP,"8/5/2022 12 p.m. PDT",5619,5715,4217,-1402
NEVP,"8/5/2022 1 p.m. PDT",5986,5844,4490,-1496
NEVP,"8/5/2022 2 p.m. PDT",6203,6162,4421,-1782
NEVP,"8/5/2022 3 p.m. PDT",6378,6436,4559,-1819
NEVP,"8/5/2022 4 p.m. PDT",6527,6364,4807,-1720
NEVP,"8/5/2022 5 p.m. PDT",6674,6546,5126,-1548
NEVP,"8/5/2022 6 p.m. PDT",6716,6351,5244,-1472
NEVP,"8/5/2022 7 p.m. PDT",6600,6344,4953,-1647
NEVP,"8/5/2022 8 p.m. PDT",6359,6279,4497,-1862
NEVP,"8/5/2022 9 p.m. PDT",6213,6072,4508,-1705
NEVP,"8/5/2022 10 p.m. PDT",5974,5830,4221,-1753
NEVP,"8/5/2022 11 p.m. PDT",5671,5537,4202,-1469
NEVP,"8/6/2022 12 a.m. PDT",5355,5147,4095,-1260
NEVP,"8/6/2022 1 a.m. PDT",5045,4669,3879,-1166
NEVP,"8/6/2022 2 a.m. PDT",4810,4457,3686,-1124
NEVP,"8/6/2022 3 a.m. PDT",4636,4311,3845,-791
NEVP,"8/6/2022 4 a.m. PDT",4494,4226,3686,-808
NEVP,"8/6/2022 5 a.m. PDT",4422,4117,3534,-888
NEVP,"8/6/2022 6 a.m. PDT",4403,4081,3507,-896
NEVP,"8/6/2022 7 a.m. PDT",4330,4044,2866,-1464
NEVP,"8/6/2022 8 a.m. PDT",4563,4128,3426,-1137
NEVP,"8/6/2022 9 a.m. PDT",4984,4455,3594,-1390
NEVP,"8/6/2022 10 a.m. PDT",5330,4726,3799,-1531
NEVP,"8/6/2022 11 a.m. PDT",5691,5100,3902,-1789
NEVP,"8/6/2022 12 p.m. PDT",6026,5399,3938,-2088
NEVP,"8/6/2022 1 p.m. PDT",6314,5639,4049,-2265
NEVP,"8/6/2022 2 p.m. PDT",6647,5993,4290,-2357
NEVP,"8/6/2022 3 p.m. PDT",6980,6275,4498,-2482
NEVP,"8/6/2022 4 p.m. PDT",7306,6301,4888,-2418
NEVP,"8/6/2022 5 p.m. PDT",7548,6633,5041,-2507
NEVP,"8/6/2022 6 p.m. PDT",7566,6566,5343,-2223
NEVP,"8/6/2022 7 p.m. PDT",7582,6478,5088,-2494
NEVP,"8/6/2022 8 p.m. PDT",7181,6207,4447,-2734
NEVP,"8/6/2022 9 p.m. PDT",6882,5940,4346,-2536
NEVP,"8/6/2022 10 p.m. PDT",6504,5697,4140,-2364
NEVP,"8/6/2022 11 p.m. PDT",6094,5344,4373,-1721
NEVP,"8/7/2022 12 a.m. PDT",5682,5072,4496,-1186
NEVP,"8/7/2022 1 a.m. PDT",5311,4746,4339,-972
NEVP,"8/7/2022 2 a.m. PDT",5032,4506,4031,-1001
NEVP,"8/7/2022 3 a.m. PDT",6090,4293,5062,-1028
NEVP,"8/7/2022 4 a.m. PDT",4615,4237,3558,-1057
NEVP,"8/7/2022 5 a.m. PDT",4504,4192,3595,-909
NEVP,"8/7/2022 6 a.m. PDT",4423,4053,3623,-800
NEVP,"8/7/2022 7 a.m. PDT",4351,4069,2843,-1508
NEVP,"8/7/2022 8 a.m. PDT",4608,4178,3435,-1173
NEVP,"8/7/2022 9 a.m. PDT",4971,4492,3710,-1261
NEVP,"8/7/2022 10 a.m. PDT",5342,4806,3788,-1554
NEVP,"8/7/2022 11 a.m. PDT",5745,5342,4000,-1745
NEVP,"8/7/2022 12 p.m. PDT",6133,5806,4381,-1752
NEVP,"8/7/2022 1 p.m. PDT",6521,6136,4565,-1956
NEVP,"8/7/2022 2 p.m. PDT",6894,6478,4872,-2022
NEVP,"8/7/2022 3 p.m. PDT",7304,6673,4932,-2372
NEVP,"8/7/2022 4 p.m. PDT",7631,6983,5244,-2387
NEVP,"8/7/2022 5 p.m. PDT",7846,7084,5615,-2231
NEVP,"8/7/2022 6 p.m. PDT",7951,7084,6280,-1671
NEVP,"8/7/2022 7 p.m. PDT",7835,7033,5659,-2176
NEVP,"8/7/2022 8 p.m. PDT",7493,6552,5064,-2429
NEVP,"8/7/2022 9 p.m. PDT",7176,6247,5094,-2082
NEVP,"8/7/2022 10 p.m. PDT",6775,5959,5003,-1772
NEVP,"8/7/2022 11 p.m. PDT",6258,5497,4844,-1414
NEVP,"8/8/2022 12 a.m. PDT",5853,5217,4739,-1114
NEVP,"8/8/2022 1 a.m. PDT",5476,4934,4540,-936
NEVP,"8/8/2022 2 a.m. PDT",5190,4663,4032,-1158
NEVP,"8/8/2022 3 a.m. PDT",4983,4441,3807,-1176
NEVP,"8/8/2022 4 a.m. PDT",4834,4367,3541,-1293
NEVP,"8/8/2022 5 a.m. PDT",4780,4312,3483,-1297
NEVP,"8/8/2022 6 a.m. PDT",4826,4338,3507,-1319
NEVP,"8/8/2022 7 a.m. PDT",4879,4343,3173,-1706
NEVP,"8/8/2022 8 a.m. PDT",5112,4522,3420,-1692
NEVP,"8/8/2022 9 a.m. PDT",5468,4893,4020,-1448
NEVP,"8/8/2022 10 a.m. PDT",5831,5184,4016,-1815
NEVP,"8/8/2022 11 a.m. PDT",6204,5644,4465,-1739
NEVP,"8/8/2022 12 p.m. PDT",6635,6007,4613,-2022
NEVP,"8/8/2022 1 p.m. PDT",6856,6263,4754,-2102
NEVP,"8/8/2022 2 p.m. PDT",7378,6642,5362,-2016
NEVP,"8/8/2022 3 p.m. PDT",7593,7069,5640,-1953
NEVP,"8/8/2022 4 p.m. PDT",7840,7159,5718,-2122
NEVP,"8/8/2022 5 p.m. PDT",7830,7456,5729,-2101
NEVP,"8/8/2022 6 p.m. PDT",7661,7392,5855,-1806
NEVP,"8/8/2022 7 p.m. PDT",7505,7104,5424,-2081
NEVP,"8/8/2022 8 p.m. PDT",7309,6643,4763,-2546
NEVP,"8/8/2022 9 p.m. PDT",7147,6231,4699,-2448
NEVP,"8/8/2022 10 p.m. PDT",6835,5968,4651,-2184
NEVP,"8/8/2022 11 p.m. PDT",6448,5570,4715,-1733
NEVP,"8/9/2022 12 a.m. PDT",6025,5141,4625,-1400
NEVP,"8/9/2022 1 a.m. PDT",5664,4879,4362,-1302
NEVP,"8/9/2022 2 a.m. PDT",5375,4654,4009,-1366
NEVP,"8/9/2022 3 a.m. PDT",5188,4496,3718,-1470
NEVP,"8/9/2022 4 a.m. PDT",5066,4433,3516,-1550
NEVP,"8/9/2022 5 a.m. PDT",5005,4400,3363,-1642
NEVP,"8/9/2022 6 a.m. PDT",5029,4440,3315,-1714
NEVP,"8/9/2022 7 a.m. PDT",5053,4436,3657,-1396
NEVP,"8/9/2022 8 a.m. PDT",5179,4694,3758,-1421
NEVP,"8/9/2022 9 a.m. PDT",5511,4996,4089,-1422
NEVP,"8/9/2022 10 a.m. PDT",5765,5246,4328,-1437
NEVP,"8/9/2022 11 a.m. PDT",6039,5475,4317,-1722
NEVP,"8/9/2022 12 p.m. PDT",6376,5749,4443,-1933
NEVP,"8/9/2022 1 p.m. PDT",6694,6140,4841,-1853
NEVP,"8/9/2022 2 p.m. PDT",6816,6394,5035,-1781
NEVP,"8/9/2022 3 p.m. PDT",7027,6587,5294,-1733
NEVP,"8/9/2022 4 p.m. PDT",6971,6611,5356,-1615
NEVP,"8/9/2022 5 p.m. PDT",6910,6700,5470,-1440
NEVP,"8/9/2022 6 p.m. PDT",6719,6619,4982,-1737
NEVP,"8/9/2022 7 p.m. PDT",6537,6397,4524,-2013
NEVP,"8/9/2022 8 p.m. PDT",6363,6250,4263,-2100
NEVP,"8/9/2022 9 p.m. PDT",6222,6084,4112,-2110
NEVP,"8/9/2022 10 p.m. PDT",5952,5841,3910,-2042
NEVP,"8/9/2022 11 p.m. PDT",5601,5476,3905,-1696
NEVP,"8/10/2022 12 a.m. PDT",5283,5141,3785,-1498
NEVP,"8/10/2022 1 a.m. PDT",5009,4822,3913,-1096
NEVP,"8/10/2022 2 a.m. PDT",4818,4596,3852,-966
NEVP,"8/10/2022 3 a.m. PDT",4676,4431,3705,-971
NEVP,"8/10/2022 4 a.m. PDT",4581,4315,3886,-695
NEVP,"8/10/2022 5 a.m. PDT",4546,4278,3988,-558
NEVP,"8/10/2022 6 a.m. PDT",4590,4350,3944,-646
NEVP,"8/10/2022 7 a.m. PDT",4667,4393,4052,-615
NEVP,"8/10/2022 8 a.m. PDT",4928,4506,4347,-581
NEVP,"8/10/2022 9 a.m. PDT",5308,4763,4216,-1092
NEVP,"8/10/2022 10 a.m. PDT",5635,4983,4125,-1510
NEVP,"8/10/2022 11 a.m. PDT",6003,5161,4438,-1565
NEVP,"8/10/2022 12 p.m. PDT",6315,5465,4789,-1526
NEVP,"8/10/2022 1 p.m. PDT",6719,5955,5003,-1716
NEVP,"8/10/2022 2 p.m. PDT",6852,6258,5109,-1743
NEVP,"8/10/2022 3 p.m. PDT",6946,6309,4984,-1962
NEVP,"8/10/2022 4 p.m. PDT",6757,6608,4878,-1879
NEVP,"8/10/2022 5 p.m. PDT",6680,6563,5087,-1593
NEVP,"8/10/2022 6 p.m. PDT",6869,6359,5188,-1681
NEVP,"8/10/2022 7 p.m. PDT",6902,6268,4988,-1914
NEVP,"8/10/2022 8 p.m. PDT",6744,6118,4824,-1920
NEVP,"8/10/2022 9 p.m. PDT",6548,6002,4786,-1762
NEVP,"8/10/2022 10 p.m. PDT",6214,5740,4516,-1698
NEVP,"8/10/2022 11 p.m. PDT",5817,5341,4512,-1305
NEVP,"8/11/2022 12 a.m. PDT",5428,5014,4456,-972
NEVP,"8/11/2022 1 a.m. PDT",5101,4718,4319,-782
NEVP,"8/11/2022 2 a.m. PDT",4870,4507,4054,-816
NEVP,"8/11/2022 3 a.m. PDT",4703,4366,3879,-824
NEVP,"8/11/2022 4 a.m. PDT",4535,4261,3846,-689
NEVP,"8/11/2022 5 a.m. PDT",4503,4250,3899,-604
NEVP,"8/11/2022 6 a.m. PDT",4562,4337,3857,-705
NEVP,"8/11/2022 7 a.m. PDT",4607,4415,3518,-1089
NEVP,"8/11/2022 8 a.m. PDT",4802,4662,3348,-1454
NEVP,"8/11/2022 9 a.m. PDT",5122,4973,3635,-1487
NEVP,"8/11/2022 10 a.m. PDT",5453,5114,3890,-1563
NEVP,"8/11/2022 11 a.m. PDT",5840,5360,4170,-1670
NEVP,"8/11/2022 12 p.m. PDT",6243,5701,4627,-1616
NEVP,"8/11/2022 1 p.m. PDT",6635,6048,5013,-1622
NEVP,"8/11/2022 2 p.m. PDT",7069,6407,5092,-1977
NEVP,"8/11/2022 3 p.m. PDT",7340,6663,5106,-2234
NEVP,"8/11/2022 4 p.m. PDT",7471,6710,5425,-2046
NEVP,"8/11/2022 5 p.m. PDT",7621,7011,5946,-1675
NEVP,"8/11/2022 6 p.m. PDT",7667,6799,5716,-1951
NEVP,"8/11/2022 7 p.m. PDT",7610,6608,5243,-2367
NEVP,"8/11/2022 8 p.m. PDT",7369,6476,4846,-2523
NEVP,"8/11/2022 9 p.m. PDT",7125,6199,4943,-2182
NEVP,"8/11/2022 10 p.m. PDT",6486,5968,4323,-2163
NEVP,"8/11/2022 11 p.m. PDT",5884,5519,4459,-1425
NEVP,"8/12/2022 12 a.m. PDT",5498,5246,4203,-1295
NEVP,"8/12/2022 1 a.m. PDT",5152,4853,4060,-1092
NEVP,"8/12/2022 2 a.m. PDT",4894,4629,4087,-807
NEVP,"8/12/2022 3 a.m. PDT",4714,4471,4061,-653
NEVP,"8/12/2022 4 a.m. PDT",4587,4385,4057,-530
NEVP,"8/12/2022 5 a.m. PDT",4544,4385,4095,-449
NEVP,"8/12/2022 6 a.m. PDT",4583,4473,4102,-481
NEVP,"8/12/2022 7 a.m. PDT",4637,4472,3966,-671
NEVP,"8/12/2022 8 a.m. PDT",4882,4630,3443,-1439
NEVP,"8/12/2022 9 a.m. PDT",5203,4965,3861,-1342
NEVP,"8/12/2022 10 a.m. PDT",5516,5176,4122,-1394
NEVP,"8/12/2022 11 a.m. PDT",5852,5377,4265,-1587
NEVP,"8/12/2022 12 p.m. PDT",6223,5666,4767,-1456
NEVP,"8/12/2022 1 p.m. PDT",6615,6031,4817,-1798
NEVP,"8/12/2022 2 p.m. PDT",6893,6344,5052,-1841
NEVP,"8/12/2022 3 p.m. PDT",6972,6619,5245,-1727
NEVP,"8/12/2022 4 p.m. PDT",6821,6662,4883,-1938
NEVP,"8/12/2022 5 p.m. PDT",6730,6656,4765,-1965
NEVP,"8/12/2022 6 p.m. PDT",6509,6658,4580,-1929
NEVP,"8/12/2022 7 p.m. PDT",6245,6511,4394,-1851
NEVP,"8/12/2022 8 p.m. PDT",6069,6257,4427,-1642
NEVP,"8/12/2022 9 p.m. PDT",5944,6129,4361,-1583
NEVP,"8/12/2022 10 p.m. PDT",5727,5884,4295,-1432
NEVP,"8/12/2022 11 p.m. PDT",5437,5532,4322,-1115
NEVP,"8/13/2022 12 a.m. PDT",5139,5153,4239,-900
NEVP,"8/13/2022 1 a.m. PDT",4890,4818,4188,-702
NEVP,"8/13/2022 2 a.m. PDT",4689,4595,4142,-547
NEVP,"8/13/2022 3 a.m. PDT",4535,4482,3984,-551
NEVP,"8/13/2022 4 a.m. PDT",4430,4363,3724,-706
NEVP,"8/13/2022 5 a.m. PDT",4385,4300,3895,-490
NEVP,"8/13/2022 6 a.m. PDT",4392,4257,3752,-640
NEVP,"8/13/2022 7 a.m. PDT",4378,4241,3678,-700
NEVP,"8/13/2022 8 a.m. PDT",4529,4281,2511,-2018
NEVP,"8/13/2022 9 a.m. PDT",4760,4553,2727,-2033
NEVP,"8/13/2022 10 a.m. PDT",4966,4858,2951,-2015
NEVP,"8/13/2022 11 a.m. PDT",5141,5137,3407,-1734
NEVP,"8/13/2022 12 p.m. PDT",5340,5423,3663,-1677
NEVP,"8/13/2022 1 p.m. PDT",5499,5778,4012,-1487
NEVP,"8/13/2022 2 p.m. PDT",5767,6076,4445,-1322
NEVP,"8/13/2022 3 p.m. PDT",6079,6358,4870,-1209
NEVP,"8/13/2022 4 p.m. PDT",6227,6313,4556,-1671
NEVP,"8/13/2022 5 p.m. PDT",6351,6371,4568,-1783
NEVP,"8/13/2022 6 p.m. PDT",6353,6387,4769,-1584
NEVP,"8/13/2022 7 p.m. PDT",6309,6380,4850,-1459
NEVP,"8/13/2022 8 p.m. PDT",6181,6236,4245,-1936
NEVP,"8/13/2022 9 p.m. PDT",6052,6128,4267,-1785
NEVP,"8/13/2022 10 p.m. PDT",5816,5906,4106,-1710
NEVP,"8/13/2022 11 p.m. PDT",5541,5489,4093,-1448
NEVP,"8/14/2022 12 a.m. PDT",5238,5310,3977,-1261
NEVP,"8/14/2022 1 a.m. PDT",4973,4912,3851,-1122
NEVP,"8/14/2022 2 a.m. PDT",4761,4754,3445,-1316
NEVP,"8/14/2022 3 a.m. PDT",4594,4629,3373,-1221
NEVP,"8/14/2022 4 a.m. PDT",4496,4484,3253,-1243
NEVP,"8/14/2022 5 a.m. PDT",4431,4401,3181,-1250
NEVP,"8/14/2022 6 a.m. PDT",4405,4379,3157,-1248
NEVP,"8/14/2022 7 a.m. PDT",4341,4299,2696,-1645
NEVP,"8/14/2022 8 a.m. PDT",4501,4417,2764,-1737
NEVP,"8/14/2022 9 a.m. PDT",4788,4642,3566,-1222
NEVP,"8/14/2022 10 a.m. PDT",5192,4938,3927,-1265
NEVP,"8/14/2022 11 a.m. PDT",5610,5227,3991,-1619
NEVP,"8/14/2022 12 p.m. PDT",5970,5651,4343,-1627
NEVP,"8/14/2022 1 p.m. PDT",6308,6133,4442,-1866
NEVP,"8/14/2022 2 p.m. PDT",6616,6402,4614,-2002
NEVP,"8/14/2022 3 p.m. PDT",6751,6558,5262,-1489
NEVP,"8/14/2022 4 p.m. PDT",6890,6684,5257,-1633
NEVP,"8/14/2022 5 p.m. PDT",6973,6737,5071,-1902
NEVP,"8/14/2022 6 p.m. PDT",6926,6729,5023,-1903
NEVP,"8/14/2022 7 p.m. PDT",6775,6662,4991,-1784
NEVP,"8/14/2022 8 p.m. PDT",6637,6508,4802,-1835
NEVP,"8/14/2022 9 p.m. PDT",6484,6361,4800,-1684
NEVP,"8/14/2022 10 p.m. PDT",6094,6203,4532,-1562
NEVP,"8/14/2022 11 p.m. PDT",5641,5794,4701,-940
NEVP,"8/15/2022 12 a.m. PDT",5246,5419,4381,-865
NEVP,"8/15/2022 1 a.m. PDT",4940,4984,4150,-790
NEVP,"8/15/2022 2 a.m. PDT",4690,4827,4044,-646
NEVP,"8/15/2022 3 a.m. PDT",4538,4706,3833,-705
NEVP,"8/15/2022 4 a.m. PDT",4447,4526,3721,-726
NEVP,"8/15/2022 5 a.m. PDT",4433,4429,3667,-766
NEVP,"8/15/2022 6 a.m. PDT",4494,4464,3748,-746
NEVP,"8/15/2022 7 a.m. PDT",4553,4508,3038,-1515
NEVP,"8/15/2022 8 a.m. PDT",4743,4707,2723,-2020
NEVP,"8/15/2022 9 a.m. PDT",4961,4963,3334,-1627
NEVP,"8/15/2022 10 a.m. PDT",5277,5153,3550,-1727
NEVP,"8/15/2022 11 a.m. PDT",5493,5490,3340,-2153
NEVP,"8/15/2022 12 p.m. PDT",5769,5814,3766,-2003
NEVP,"8/15/2022 1 p.m. PDT",6091,6203,3891,-2200
NEVP,"8/15/2022 2 p.m. PDT",6442,6572,4422,-2020
NEVP,"8/15/2022 3 p.m. PDT",6824,6758,4747,-2077
NEVP,"8/15/2022 4 p.m. PDT",7187,6830,5366,-1821
NEVP,"8/15/2022 5 p.m. PDT",7370,6926,5332,-2038
NEVP,"8/15/2022 6 p.m. PDT",7270,6945,5543,-1727
NEVP,"8/15/2022 7 p.m. PDT",7217,6900,5062,-2155
NEVP,"8/15/2022 8 p.m. PDT",7058,6569,4640,-2418
NEVP,"8/15/2022 9 p.m. PDT",6842,6405,4345,-2497
NEVP,"8/15/2022 10 p.m. PDT",6451,6350,4326,-2125
NEVP,"8/15/2022 11 p.m. PDT",5933,5910,4495,-1438
NEVP,"8/16/2022 12 a.m. PDT",5435,5506,4040,-1395
NEVP,"8/16/2022 1 a.m. PDT",5049,4850,3816,-1233
NEVP,"8/16/2022 2 a.m. PDT",4825,4641,3755,-1070
NEVP,"8/16/2022 3 a.m. PDT",4653,4478,3436,-1217
NEVP,"8/16/2022 4 a.m. PDT",4542,4415,3338,-1204
NEVP,"8/16/2022 5 a.m. PDT",4525,4421,3520,-1005
NEVP,"8/16/2022 6 a.m. PDT",4572,4455,3388,-1184
NEVP,"8/16/2022 7 a.m. PDT",4572,4596,3134,-1438
NEVP,"8/16/2022 8 a.m. PDT",4768,4750,2876,-1892
NEVP,"8/16/2022 9 a.m. PDT",5084,5053,2922,-2162
NEVP,"8/16/2022 10 a.m. PDT",5361,5321,3507,-1854
NEVP,"8/16/2022 11 a.m. PDT",5656,5631,3993,-1663
NEVP,"8/16/2022 12 p.m. PDT",5977,5917,4177,-1800
NEVP,"8/16/2022 1 p.m. PDT",6307,6295,4516,-1791
NEVP,"8/16/2022 2 p.m. PDT",6634,6782,5146,-1488
NEVP,"8/16/2022 3 p.m. PDT",6996,7015,5734,-1262
NEVP,"8/16/2022 4 p.m. PDT",7340,6976,5995,-1345
NEVP,"8/16/2022 5 p.m. PDT",7574,7030,6175,-1399
NEVP,"8/16/2022 6 p.m. PDT",7694,6986,5870,-1824
NEVP,"8/16/2022 7 p.m. PDT",7586,6885,5491,-2095
NEVP,"8/16/2022 8 p.m. PDT",7327,6659,5092,-2235
NEVP,"8/16/2022 9 p.m. PDT",7075,6633,4992,-2083
NEVP,"8/16/2022 10 p.m. PDT",6717,6355,4984,-1733
NEVP,"8/16/2022 11 p.m. PDT",6277,5898,4711,-1566
NEVP,"8/17/2022 12 a.m. PDT",5846,5518,4133,-1713
NEVP,"8/17/2022 1 a.m. PDT",5478,4977,4201,-1277
NEVP,"8/17/2022 2 a.m. PDT",5191,4731,4120,-1071
NEVP,"8/17/2022 3 a.m. PDT",4974,4554,3815,-1159
NEVP,"8/17/2022 4 a.m. PDT",4819,4435,3823,-996
NEVP,"8/17/2022 5 a.m. PDT",4757,4432,3776,-981
NEVP,"8/17/2022 6 a.m. PDT",4789,4456,3857,-932
NEVP,"8/17/2022 7 a.m. PDT",4827,4494,3510,-1317
NEVP,"8/17/2022 8 a.m. PDT",5033,4747,3446,-1587
NEVP,"8/17/2022 9 a.m. PDT",5361,5102,3742,-1619
NEVP,"8/17/2022 10 a.m. PDT",5726,5459,4173,-1553
NEVP,"8/17/2022 11 a.m. PDT",6106,5831,4561,-1545
NEVP,"8/17/2022 12 p.m. PDT",6493,6030,4637,-1856
NEVP,"8/17/2022 1 p.m. PDT",6849,6430,4957,-1892
NEVP,"8/17/2022 2 p.m. PDT",7179,6850,5364,-1815
NEVP,"8/17/2022 3 p.m. PDT",7522,6765,5923,-1599
NEVP,"8/17/2022 4 p.m. PDT",7801,6839,5531,-2270
NEVP,"8/17/2022 5 p.m. PDT",7928,6834,5221,-2707
NEVP,"8/17/2022 6 p.m. PDT",7770,6790,5194,-2576
NEVP,"8/17/2022 7 p.m. PDT",7623,6903,5095,-2528
NEVP,"8/17/2022 8 p.m. PDT",7404,6654,4815,-2589
NEVP,"8/17/2022 9 p.m. PDT",7143,6513,4878,-2265
NEVP,"8/17/2022 10 p.m. PDT",6729,6286,4750,-1979
NEVP,"8/17/2022 11 p.m. PDT",6301,5820,4748,-1553
NEVP,"8/18/2022 12 a.m. PDT",5880,5447,4540,-1340
NEVP,"8/18/2022 1 a.m. PDT",5512,5001,4436,-1076
NEVP,"8/18/2022 2 a.m. PDT",5240,4793,4201,-1039
NEVP,"8/18/2022 3 a.m. PDT",5043,4592,3755,-1288
NEVP,"8/18/2022 4 a.m. PDT",4881,4474,3709,-1172
NEVP,"8/18/2022 5 a.m. PDT",4827,4447,3682,-1145
NEVP,"8/18/2022 6 a.m. PDT",4867,4490,3812,-1055
NEVP,"8/18/2022 7 a.m. PDT",4870,4553,3331,-1539
NEVP,"8/18/2022 8 a.m. PDT",5044,4690,3537,-1507
NEVP,"8/18/2022 9 a.m. PDT",5392,4943,3813,-1579
NEVP,"8/18/2022 10 a.m. PDT",5760,5125,4258,-1502
NEVP,"8/18/2022 11 a.m. PDT",6091,5444,4522,-1569
NEVP,"8/18/2022 12 p.m. PDT",6419,5765,4808,-1611
NEVP,"8/18/2022 1 p.m. PDT",6789,5997,5383,-1406
NEVP,"8/18/2022 2 p.m. PDT",7112,6392,5315,-1797
NEVP,"8/18/2022 3 p.m. PDT",7199,6513,5108,-2091
NEVP,"8/18/2022 4 p.m. PDT",7075,6674,5221,-1854
NEVP,"8/18/2022 5 p.m. PDT",6995,6670,5607,-1388
NEVP,"8/18/2022 6 p.m. PDT",7080,6688,5583,-1497
NEVP,"8/18/2022 7 p.m. PDT",7017,6702,4990,-2027
NEVP,"8/18/2022 8 p.m. PDT",6828,6633,4706,-2122
NEVP,"8/18/2022 9 p.m. PDT",6586,6412,4720,-1866
NEVP,"8/18/2022 10 p.m. PDT",6225,6162,4611,-1614
NEVP,"8/18/2022 11 p.m. PDT",5848,5653,4510,-1338
NEVP,"8/19/2022 12 a.m. PDT",5446,5252,4332,-1114
NEVP,"8/19/2022 1 a.m. PDT",4986,4927,4272,-714
NEVP,"8/19/2022 2 a.m. PDT",4727,4650,4172,-555
NEVP,"8/19/2022 3 a.m. PDT",4556,4433,4066,-490
NEVP,"8/19/2022 4 a.m. PDT",4451,4343,4006,-445
NEVP,"8/19/2022 5 a.m. PDT",4424,4307,3985,-439
NEVP,"8/19/2022 6 a.m. PDT",4470,4422,3876,-594
NEVP,"8/19/2022 7 a.m. PDT",4494,4484,3253,-1241
NEVP,"8/19/2022 8 a.m. PDT",4730,4544,3478,-1252
NEVP,"8/19/2022 9 a.m. PDT",5060,4832,3617,-1443
NEVP,"8/19/2022 10 a.m. PDT",5359,5067,3810,-1549
NEVP,"8/19/2022 11 a.m. PDT",5694,5416,4152,-1542
NEVP,"8/19/2022 12 p.m. PDT",5993,5760,4476,-1517
NEVP,"8/19/2022 1 p.m. PDT",6326,6030,4796,-1530
NEVP,"8/19/2022 2 p.m. PDT",6696,6409,4840,-1856
NEVP,"8/19/2022 3 p.m. PDT",7063,6515,5132,-1931
NEVP,"8/19/2022 4 p.m. PDT",7363,6617,5207,-2156
NEVP,"8/19/2022 5 p.m. PDT",7584,6941,5318,-2266
NEVP,"8/19/2022 6 p.m. PDT",7642,6865,4986,-2656
NEVP,"8/19/2022 7 p.m. PDT",7447,6643,4782,-2665
NEVP,"8/19/2022 8 p.m. PDT",7139,6444,4461,-2678
NEVP,"8/19/2022 9 p.m. PDT",6843,6251,4440,-2403
NEVP,"8/19/2022 10 p.m. PDT",6447,5963,4483,-1964
NEVP,"8/19/2022 11 p.m. PDT",6033,5596,4400,-1633
NEVP,"8/20/2022 12 a.m. PDT",5618,5233,4239,-1379
NEVP,"8/20/2022 1 a.m. PDT",5255,4698,4061,-1194
NEVP,"8/20/2022 2 a.m. PDT",4979,4518,3913,-1066
NEVP,"8/20/2022 3 a.m. PDT",4775,4324,3698,-1077
NEVP,"8/20/2022 4 a.m. PDT",4645,4253,3565,-1080
NEVP,"8/20/2022 5 a.m. PDT",4579,4146,3560,-1019
NEVP,"8/20/2022 6 a.m. PDT",4551,4170,3280,-1271
NEVP,"8/20/2022 7 a.m. PDT",4480,4249,2969,-1511
NEVP,"8/20/2022 8 a.m. PDT",4686,4282,2804,-1882
NEVP,"8/20/2022 9 a.m. PDT",5047,4560,3307,-1740
NEVP,"8/20/2022 10 a.m. PDT",5406,4834,3689,-1717
NEVP,"8/20/2022 11 a.m. PDT",5775,5161,3968,-1807
NEVP,"8/20/2022 12 p.m. PDT",6115,5497,4374,-1741
NEVP,"8/20/2022 1 p.m. PDT",6463,5722,4723,-1740
NEVP,"8/20/2022 2 p.m. PDT",6863,6166,4788,-2075
NEVP,"8/20/2022 3 p.m. PDT",7225,6544,5114,-2111
NEVP,"8/20/2022 4 p.m. PDT",7443,6633,5297,-2146
NEVP,"8/20/2022 5 p.m. PDT",7361,6529,5178,-2183
NEVP,"8/20/2022 6 p.m. PDT",7090,6575,5165,-1925
NEVP,"8/20/2022 7 p.m. PDT",6888,6521,4887,-2001
NEVP,"8/20/2022 8 p.m. PDT",6679,6299,4582,-2097
NEVP,"8/20/2022 9 p.m. PDT",6440,6196,4516,-1924
NEVP,"8/20/2022 10 p.m. PDT",6106,5807,4511,-1595
NEVP,"8/20/2022 11 p.m. PDT",5761,5601,4442,-1319
NEVP,"8/21/2022 12 a.m. PDT",5445,5216,4328,-1117
NEVP,"8/21/2022 1 a.m. PDT",5185,4933,4100,-1085
NEVP,"8/21/2022 2 a.m. PDT",4973,4660,3939,-1034
NEVP,"8/21/2022 3 a.m. PDT",4796,4439,3774,-1022
NEVP,"8/21/2022 4 a.m. PDT",4664,4329,3742,-922
NEVP,"8/21/2022 5 a.m. PDT",4568,4265,3700,-868
NEVP,"8/21/2022 6 a.m. PDT",4518,4168,3656,-862
NEVP,"8/21/2022 7 a.m. PDT",4428,4182,2810,-1618
NEVP,"8/21/2022 8 a.m. PDT",4646,4186,3038,-1608
NEVP,"8/21/2022 9 a.m. PDT",5041,4455,3584,-1457
NEVP,"8/21/2022 10 a.m. PDT",5453,4809,3806,-1647
NEVP,"8/21/2022 11 a.m. PDT",5861,5143,4027,-1834
NEVP,"8/21/2022 12 p.m. PDT",6253,5516,4461,-1792
NEVP,"8/21/2022 1 p.m. PDT",6637,6015,4881,-1756
NEVP,"8/21/2022 2 p.m. PDT",7015,6412,5268,-1747
NEVP,"8/21/2022 3 p.m. PDT",7434,6529,5435,-1999
NEVP,"8/21/2022 4 p.m. PDT",7622,6993,5476,-2146
NEVP,"8/21/2022 5 p.m. PDT",7790,7033,5736,-2054
NEVP,"8/21/2022 6 p.m. PDT",7855,6994,5322,-2533
NEVP,"8/21/2022 7 p.m. PDT",7619,6940,4964,-2655
NEVP,"8/21/2022 8 p.m. PDT",7232,6704,4829,-2403
NEVP,"8/21/2022 9 p.m. PDT",6865,6576,4546,-2319
NEVP,"8/21/2022 10 p.m. PDT",6441,6063,4459,-1982
NEVP,"8/21/2022 11 p.m. PDT",5990,5700,4238,-1752
NEVP,"8/22/2022 12 a.m. PDT",5577,5305,4076,-1501
NEVP,"8/22/2022 1 a.m. PDT",5241,4941,4132,-1109
NEVP,"8/22/2022 2 a.m. PDT",4998,4699,3844,-1154
NEVP,"8/22/2022 3 a.m. PDT",4803,4474,3699,-1104
NEVP,"8/22/2022 4 a.m. PDT",4662,4345,3694,-968
NEVP,"8/22/2022 5 a.m. PDT",4601,4272,3802,-799
NEVP,"8/22/2022 6 a.m. PDT",4633,4291,3642,-991
NEVP,"8/22/2022 7 a.m. PDT",4652,4415,2813,-1839
NEVP,"8/22/2022 8 a.m. PDT",4891,4490,3221,-1670
NEVP,"8/22/2022 9 a.m. PDT",5230,4804,3854,-1376
NEVP,"8/22/2022 10 a.m. PDT",5533,5078,4080,-1453
NEVP,"8/22/2022 11 a.m. PDT",5891,5406,4489,-1402
NEVP,"8/22/2022 12 p.m. PDT",6238,5763,4759,-1479
NEVP,"8/22/2022 1 p.m. PDT",6588,6196,4991,-1597
NEVP,"8/22/2022 2 p.m. PDT",6973,6619,5243,-1730
NEVP,"8/22/2022 3 p.m. PDT",7390,6753,5593,-1797
NEVP,"8/22/2022 4 p.m. PDT",7758,7187,5741,-2017
NEVP,"8/22/2022 5 p.m. PDT",8005,7403,5923,-2082
NEVP,"8/22/2022 6 p.m. PDT",8058,7320,5654,-2404
NEVP,"8/22/2022 7 p.m. PDT",7788,7188,5142,-2646
NEVP,"8/22/2022 8 p.m. PDT",7419,6821,4851,-2568
NEVP,"8/22/2022 9 p.m. PDT",7124,6608,4886,-2238
NEVP,"8/22/2022 10 p.m. PDT",6684,6209,4815,-1869
NEVP,"8/22/2022 11 p.m. PDT",6153,5831,4706,-1447
NEVP,"8/23/2022 12 a.m. PDT",5679,5365,4180,-1499
NEVP,"8/23/2022 1 a.m. PDT",5287,5157,4042,-1245
NEVP,"8/23/2022 2 a.m. PDT",4999,4853,3978,-1021
NEVP,"8/23/2022 3 a.m. PDT",4784,4609,3636,-1148
NEVP,"8/23/2022 4 a.m. PDT",4632,4482,3544,-1088
NEVP,"8/23/2022 5 a.m. PDT",4569,4363,3438,-1131
NEVP,"8/23/2022 6 a.m. PDT",4583,4345,3315,-1268
NEVP,"8/23/2022 7 a.m. PDT",4609,4428,3191,-1418
NEVP,"8/23/2022 8 a.m. PDT",4888,4580,3617,-1271
NEVP,"8/23/2022 9 a.m. PDT",5247,4861,3991,-1256
NEVP,"8/23/2022 10 a.m. PDT",5581,5291,4289,-1292
NEVP,"8/23/2022 11 a.m. PDT",5966,5713,4538,-1428
NEVP,"8/23/2022 12 p.m. PDT",6318,6041,5071,-1247
NEVP,"8/23/2022 1 p.m. PDT",6757,6418,5316,-1441
NEVP,"8/23/2022 2 p.m. PDT",7222,6832,5583,-1639
NEVP,"8/23/2022 3 p.m. PDT",7628,7198,5700,-1928
NEVP,"8/23/2022 4 p.m. PDT",7967,7515,6257,-1710
NEVP,"8/23/2022 5 p.m. PDT",8214,7682,6400,-1814
NEVP,"8/23/2022 6 p.m. PDT",8269,7723,6161,-2108
NEVP,"8/23/2022 7 p.m. PDT",8007,7594,5462,-2545
NEVP,"8/23/2022 8 p.m. PDT",7592,7311,5354,-2238
NEVP,"8/23/2022 9 p.m. PDT",7244,6888,5223,-2021
NEVP,"8/23/2022 10 p.m. PDT",6839,6438,5121,-1718
NEVP,"8/23/2022 11 p.m. PDT",6324,5943,4881,-1443
NEVP,"8/24/2022 12 a.m. PDT",5853,5473,4638,-1215
NEVP,"8/24/2022 1 a.m. PDT",5472,5061,4559,-913
NEVP,"8/24/2022 2 a.m. PDT",5244,4745,4434,-810
NEVP,"8/24/2022 3 a.m. PDT",5050,4532,4220,-830
NEVP,"8/24/2022 4 a.m. PDT",4909,4412,3808,-1101
NEVP,"8/24/2022 5 a.m. PDT",4864,4319,3561,-1303
NEVP,"8/24/2022 6 a.m. PDT",4905,4353,3201,-1704
NEVP,"8/24/2022 7 a.m. PDT",4930,4421,2932,-1998
NEVP,"8/24/2022 8 a.m. PDT",5063,4547,3359,-1704
NEVP,"8/24/2022 9 a.m. PDT",5333,4887,3627,-1706
NEVP,"8/24/2022 10 a.m. PDT",5678,5274,4178,-1500
NEVP,"8/24/2022 11 a.m. PDT",6045,5674,4538,-1507
NEVP,"8/24/2022 12 p.m. PDT",6432,6038,5141,-1291
NEVP,"8/24/2022 1 p.m. PDT",6801,6367,5359,-1442
NEVP,"8/24/2022 2 p.m. PDT",7214,6762,5383,-1831
NEVP,"8/24/2022 3 p.m. PDT",7604,7105,5240,-2364
NEVP,"8/24/2022 4 p.m. PDT",7606,7262,5062,-2544
NEVP,"8/24/2022 5 p.m. PDT",7365,6915,5119,-2246
NEVP,"8/24/2022 6 p.m. PDT",7130,6857,5467,-1663
NEVP,"8/24/2022 7 p.m. PDT",6887,6653,5259,-1628
NEVP,"8/24/2022 8 p.m. PDT",6684,6570,5019,-1665
NEVP,"8/24/2022 9 p.m. PDT",6493,6230,4793,-1700
NEVP,"8/24/2022 10 p.m. PDT",6146,5791,4445,-1701
NEVP,"8/24/2022 11 p.m. PDT",5746,5350,4323,-1423
NEVP,"8/25/2022 12 a.m. PDT",5386,5015,4271,-1115
NEVP,"8/25/2022 1 a.m. PDT",5101,4683,3788,-1313
NEVP,"8/25/2022 2 a.m. PDT",4865,4447,3595,-1270
NEVP,"8/25/2022 3 a.m. PDT",4691,4287,3638,-1053
NEVP,"8/25/2022 4 a.m. PDT",4580,4129,3443,-1137
NEVP,"8/25/2022 5 a.m. PDT",4547,4057,3081,-1466
NEVP,"8/25/2022 6 a.m. PDT",4592,4128,3063,-1529
NEVP,"8/25/2022 7 a.m. PDT",4645,4228,2706,-1939
NEVP,"8/25/2022 8 a.m. PDT",4822,4530,2758,-2064
NEVP,"8/25/2022 9 a.m. PDT",5141,4832,3645,-1496
NEVP,"8/25/2022 10 a.m. PDT",5471,5169,3951,-1520
NEVP,"8/25/2022 11 a.m. PDT",5723,5472,4255,-1468
NEVP,"8/25/2022 12 p.m. PDT",5978,5773,4686,-1292
NEVP,"8/25/2022 1 p.m. PDT",6368,6181,5294,-1074
NEVP,"8/25/2022 2 p.m. PDT",6689,6596,5810,-879
NEVP,"8/25/2022 3 p.m. PDT",7049,6916,6011,-1038
NEVP,"8/25/2022 4 p.m. PDT",7267,7050,6032,-1235
NEVP,"8/25/2022 5 p.m. PDT",7346,6846,5883,-1463
NEVP,"8/25/2022 6 p.m. PDT",7283,6805,5046,-2237
NEVP,"8/25/2022 7 p.m. PDT",7138,6654,4567,-2571
NEVP,"8/25/2022 8 p.m. PDT",6915,6609,4487,-2428
NEVP,"8/25/2022 9 p.m. PDT",6655,6315,4567,-2088
NEVP,"8/25/2022 10 p.m. PDT",6293,5945,4307,-1986
NEVP,"8/25/2022 11 p.m. PDT",5888,5466,4296,-1592
NEVP,"8/26/2022 12 a.m. PDT",5505,5126,4113,-1392
NEVP,"8/26/2022 1 a.m. PDT",5163,4796,4031,-1132
NEVP,"8/26/2022 2 a.m. PDT",4911,4579,3881,-1030
NEVP,"8/26/2022 3 a.m. PDT",4739,4381,3856,-883
NEVP,"8/26/2022 4 a.m. PDT",4601,4209,3766,-835
NEVP,"8/26/2022 5 a.m. PDT",4548,4185,3671,-877
NEVP,"8/26/2022 6 a.m. PDT",4558,4218,3490,-1068
NEVP,"8/26/2022 7 a.m. PDT",4595,4324,2894,-1701
NEVP,"8/26/2022 8 a.m. PDT",4812,4551,3155,-1657
NEVP,"8/26/2022 9 a.m. PDT",5117,4888,3705,-1412
NEVP,"8/26/2022 10 a.m. PDT",5455,5144,3975,-1480
NEVP,"8/26/2022 11 a.m. PDT",5832,5501,4329,-1503
NEVP,"8/26/2022 12 p.m. PDT",6194,5855,4383,-1811
NEVP,"8/26/2022 1 p.m. PDT",6552,6150,4776,-1776
NEVP,"8/26/2022 2 p.m. PDT",6975,6517,5097,-1878
NEVP,"8/26/2022 3 p.m. PDT",7322,6887,5415,-1907
NEVP,"8/26/2022 4 p.m. PDT",7598,7002,5786,-1812
NEVP,"8/26/2022 5 p.m. PDT",7783,7028,5779,-2004
NEVP,"8/26/2022 6 p.m. PDT",7785,6962,5600,-2185
NEVP,"8/26/2022 7 p.m. PDT",7546,6726,4898,-2648
NEVP,"8/26/2022 8 p.m. PDT",7205,6461,4589,-2616
NEVP,"8/26/2022 9 p.m. PDT",6895,6156,4588,-2307
NEVP,"8/26/2022 10 p.m. PDT",6498,5820,4572,-1926
NEVP,"8/26/2022 11 p.m. PDT",6078,5420,4748,-1330
NEVP,"8/27/2022 12 a.m. PDT",5642,5002,4484,-1158
NEVP,"8/27/2022 1 a.m. PDT",5278,4841,4424,-854
NEVP,"8/27/2022 2 a.m. PDT",5021,4599,4263,-758
NEVP,"8/27/2022 3 a.m. PDT",4811,4398,3626,-1185
NEVP,"8/27/2022 4 a.m. PDT",4630,4277,3549,-1081
NEVP,"8/27/2022 5 a.m. PDT",4508,4240,3461,-1047
NEVP,"8/27/2022 6 a.m. PDT",4427,4179,3181,-1246
NEVP,"8/27/2022 7 a.m. PDT",4331,4196,2540,-1791
NEVP,"8/27/2022 8 a.m. PDT",4552,4264,3122,-1430
NEVP,"8/27/2022 9 a.m. PDT",4921,4606,3510,-1411
NEVP,"8/27/2022 10 a.m. PDT",5296,4952,3726,-1570
NEVP,"8/27/2022 11 a.m. PDT",5709,5445,4036,-1673
NEVP,"8/27/2022 12 p.m. PDT",6056,5674,4330,-1726
NEVP,"8/27/2022 1 p.m. PDT",6428,6002,4557,-1871
NEVP,"8/27/2022 2 p.m. PDT",6806,6349,4744,-2062
NEVP,"8/27/2022 3 p.m. PDT",7106,6752,5184,-1922
NEVP,"8/27/2022 4 p.m. PDT",7360,6839,5429,-1931
NEVP,"8/27/2022 5 p.m. PDT",7490,6974,5524,-1966
NEVP,"8/27/2022 6 p.m. PDT",7473,7030,5326,-2147
NEVP,"8/27/2022 7 p.m. PDT",7240,6690,4699,-2541
NEVP,"8/27/2022 8 p.m. PDT",6891,6261,4346,-2545
NEVP,"8/27/2022 9 p.m. PDT",6547,5926,4328,-2219
NEVP,"8/27/2022 10 p.m. PDT",6150,5600,4170,-1980
NEVP,"8/27/2022 11 p.m. PDT",5744,5153,4345,-1399
NEVP,"8/28/2022 12 a.m. PDT",5367,4819,4198,-1169
NEVP,"8/28/2022 1 a.m. PDT",5045,4572,4025,-1020
NEVP,"8/28/2022 2 a.m. PDT",4813,4405,4221,-592
NEVP,"8/28/2022 3 a.m. PDT",4614,4218,4198,-416
NEVP,"8/28/2022 4 a.m. PDT",4471,4139,3968,-503
NEVP,"8/28/2022 5 a.m. PDT",4383,4102,3734,-649
NEVP,"8/28/2022 6 a.m. PDT",4305,4037,3594,-711
NEVP,"8/28/2022 7 a.m. PDT",4207,3933,2644,-1563
NEVP,"8/28/2022 8 a.m. PDT",4423,4012,3196,-1227
NEVP,"8/28/2022 9 a.m. PDT",4769,4334,3681,-1088
NEVP,"8/28/2022 10 a.m. PDT",5186,4619,3850,-1336
NEVP,"8/28/2022 11 a.m. PDT",5627,5090,4059,-1568
NEVP,"8/28/2022 12 p.m. PDT",6027,5414,4373,-1654
NEVP,"8/28/2022 1 p.m. PDT",6418,5881,4881,-1537
NEVP,"8/28/2022 2 p.m. PDT",6785,6140,4929,-1856
NEVP,"8/28/2022 3 p.m. PDT",7146,6570,4999,-2147
NEVP,"8/28/2022 4 p.m. PDT",7441,6818,5347,-2094
NEVP,"8/28/2022 5 p.m. PDT",7648,7097,5506,-2142
NEVP,"8/28/2022 6 p.m. PDT",7688,7189,5296,-2392
NEVP,"8/28/2022 7 p.m. PDT",7473,6859,4929,-2544
NEVP,"8/28/2022 8 p.m. PDT",7210,6491,4749,-2461
NEVP,"8/28/2022 9 p.m. PDT",6920,6122,4784,-2136
NEVP,"8/28/2022 10 p.m. PDT",6544,5795,4692,-1852
NEVP,"8/28/2022 11 p.m. PDT",6101,5268,4578,-1523
NEVP,"8/29/2022 12 a.m. PDT",5680,4897,4444,-1236
NEVP,"8/29/2022 1 a.m. PDT",5335,4618,4377,-958
NEVP,"8/29/2022 2 a.m. PDT",5064,4447,4054,-1010
NEVP,"8/29/2022 3 a.m. PDT",4861,4302,3644,-1217
NEVP,"8/29/2022 4 a.m. PDT",4723,4200,3422,-1301
NEVP,"8/29/2022 5 a.m. PDT",4646,4122,3369,-1277
NEVP,"8/29/2022 6 a.m. PDT",4680,4096,3314,-1366
NEVP,"8/29/2022 7 a.m. PDT",4709,4186,3478,-1231
NEVP,"8/29/2022 8 a.m. PDT",4979,4424,4025,-954
NEVP,"8/29/2022 9 a.m. PDT",5334,4769,4533,-801
NEVP,"8/29/2022 10 a.m. PDT",5702,5043,4401,-1301
NEVP,"8/29/2022 11 a.m. PDT",6102,5532,4696,-1406
NEVP,"8/29/2022 12 p.m. PDT",6458,5851,5005,-1453
NEVP,"8/29/2022 1 p.m. PDT",6840,6235,5582,-1258
NEVP,"8/29/2022 2 p.m. PDT",7237,6603,5698,-1539
NEVP,"8/29/2022 3 p.m. PDT",7626,7085,5692,-1934
NEVP,"8/29/2022 4 p.m. PDT",7919,7254,6045,-1874
NEVP,"8/29/2022 5 p.m. PDT",8053,7620,6158,-1895
NEVP,"8/29/2022 6 p.m. PDT",8023,7683,5992,-2031
NEVP,"8/29/2022 7 p.m. PDT",7793,7340,5441,-2352
NEVP,"8/29/2022 8 p.m. PDT",7437,6921,5187,-2250
NEVP,"8/29/2022 9 p.m. PDT",7175,6513,5250,-1925
NEVP,"8/29/2022 10 p.m. PDT",6702,6152,4962,-1740
NEVP,"8/29/2022 11 p.m. PDT",6186,5692,4871,-1315
NEVP,"8/30/2022 12 a.m. PDT",5749,5171,4493,-1256
NEVP,"8/30/2022 1 a.m. PDT",5354,5075,4438,-916
NEVP,"8/30/2022 2 a.m. PDT",5077,4849,3967,-1110
NEVP,"8/30/2022 3 a.m. PDT",4850,4617,3330,-1520
NEVP,"8/30/2022 4 a.m. PDT",4693,4491,3270,-1423
NEVP,"8/30/2022 5 a.m. PDT",4629,4437,3281,-1348
NEVP,"8/30/2022 6 a.m. PDT",4669,4396,3263,-1406
NEVP,"8/30/2022 7 a.m. PDT",4726,4489,3927,-799
NEVP,"8/30/2022 8 a.m. PDT",4919,4725,4436,-483
NEVP,"8/30/2022 9 a.m. PDT",5310,5063,4505,-805
NEVP,"8/30/2022 10 a.m. PDT",5721,5417,4778,-943
NEVP,"8/30/2022 11 a.m. PDT",6138,5931,5143,-995
NEVP,"8/30/2022 12 p.m. PDT",6701,6167,5312,-1389
NEVP,"8/30/2022 1 p.m. PDT",7249,6664,5606,-1643
NEVP,"8/30/2022 2 p.m. PDT",7695,7074,6055,-1640
NEVP,"8/30/2022 3 p.m. PDT",8106,7498,6200,-1906
NEVP,"8/30/2022 4 p.m. PDT",8419,7723,6219,-2200
NEVP,"8/30/2022 5 p.m. PDT",8565,7895,6450,-2115
NEVP,"8/30/2022 6 p.m. PDT",8538,8016,6118,-2420
NEVP,"8/30/2022 7 p.m. PDT",8218,7674,5645,-2573
NEVP,"8/30/2022 8 p.m. PDT",7785,7330,5147,-2638
NEVP,"8/30/2022 9 p.m. PDT",7394,6903,4891,-2503
NEVP,"8/30/2022 10 p.m. PDT",6875,6504,4594,-2281
NEVP,"8/30/2022 11 p.m. PDT",6325,6053,4725,-1600
NEVP,"8/31/2022 12 a.m. PDT",5844,5538,4256,-1588
NEVP,"8/31/2022 1 a.m. PDT",5428,5240,3852,-1576
NEVP,"8/31/2022 2 a.m. PDT",5136,4941,3754,-1382
NEVP,"8/31/2022 3 a.m. PDT",4905,4716,3603,-1302
NEVP,"8/31/2022 4 a.m. PDT",4747,4537,3519,-1228
NEVP,"8/31/2022 5 a.m. PDT",4686,4433,3596,-1090
NEVP,"8/31/2022 6 a.m. PDT",4703,4363,4110,-593
NEVP,"8/31/2022 7 a.m. PDT",4720,4477,4284,-436
NEVP,"8/31/2022 8 a.m. PDT",4990,4731,4952,-38
NEVP,"8/31/2022 9 a.m. PDT",5362,5080,5360,-2
NEVP,"8/31/2022 10 a.m. PDT",5809,5489,5723,-86
NEVP,"8/31/2022 11 a.m. PDT",6239,5925,5976,-263
NEVP,"8/31/2022 12 p.m. PDT",6653,6374,5962,-691
NEVP,"8/31/2022 1 p.m. PDT",7155,6865,6034,-1121
NEVP,"8/31/2022 2 p.m. PDT",7613,7329,6203,-1410
NEVP,"8/31/2022 3 p.m. PDT",8065,7835,6294,-1771
NEVP,"8/31/2022 4 p.m. PDT",8418,8064,6414,-2004
NEVP,"8/31/2022 5 p.m. PDT",8602,8261,6668,-1934
NEVP,"8/31/2022 6 p.m. PDT",8568,8260,6528,-2040
NEVP,"8/31/2022 7 p.m. PDT",8228,8056,5835,-2393
NEVP,"8/31/2022 8 p.m. PDT",7832,7674,5697,-2135
NEVP,"8/31/2022 9 p.m. PDT",7437,7286,5434,-2003
NEVP,"8/31/2022 10 p.m. PDT",6904,6774,5399,-1505
NEVP,"8/31/2022 11 p.m. PDT",6342,6217,5231,-1111
NEVP,"9/1/2022 12 a.m. PDT",5852,5637,4807,-1045
