BA Code,Timestamp (Hour Ending),Demand (MWh),Demand Forecast (MWh),Net Generation (MWh),Total Interchange (MWh)
SOCO,"1/1/2023, Central Time",477556,479703,492075,14519
SOCO,"1/2/2023, Central Time",512628,508141,527034,14406
SOCO,"1/3/2023, Central Time",541170,536012,550036,8866
SOCO,"1/4/2023, Central Time",538576,541533,552339,13763
SOCO,"1/5/2023, Central Time",577380,573750,589308,11928
SOCO,"1/6/2023, Central Time",626097,610335,634697,8600
SOCO,"1/7/2023, Central Time",594401,583765,605958,11557
SOCO,"1/8/2023, Central Time",547309,538326,569144,21835
SOCO,"1/9/2023, Central Time",601613,596641,616574,14961
SOCO,"1/10/2023, Central Time",649987,640058,659662,9675
SOCO,"1/11/2023, Central Time",604187,595286,614330,10143
SOCO,"1/12/2023, Central Time",549208,544500,560539,11331
SOCO,"1/13/2023, Central Time",661892,633979,680005,18113
SOCO,"1/14/2023, Central Time",709757,699228,723071,13314
SOCO,"1/15/2023, Central Time",696982,693657,697354,372
SOCO,"1/16/2023, Central Time",667019,667134,676754,9735
SOCO,"1/17/2023, Central Time",583551,579394,602615,19064
SOCO,"1/18/2023, Central Time",549708,555035,552397,2689
SOCO,"1/19/2023, Central Time",540956,541141,551757,10801
SOCO,"1/20/2023, Central Time",584372,570421,601267,16895
SOCO,"1/21/2023, Central Time",600358,592167,613492,13134
SOCO,"1/22/2023, Central Time",609573,600821,619883,10310
SOCO,"1/23/2023, Central Time",667400,656408,681897,14497
SOCO,"1/24/2023, Central Time",715909,703259,727126,11217
SOCO,"1/25/2023, Central Time",614009,604142,624723,10714
SOCO,"1/26/2023, Central Time",693811,688358,708116,14305
SOCO,"1/27/2023, Central Time",726006,711745,726181,175
SOCO,"1/28/2023, Central Time",668318,656806,667682,-636
SOCO,"1/29/2023, Central Time",598782,589989,597867,-915
SOCO,"1/30/2023, Central Time",577118,572778,584711,7593
SOCO,"1/31/2023, Central Time",559274,553751,593266,33992
SOCO,"2/1/2023, Central Time",573519,564870,610795,37276
SOCO,"2/2/2023, Central Time",614261,604819,643632,29371
SOCO,"2/3/2023, Central Time",651215,648212,658045,6830
SOCO,"2/4/2023, Central Time",668051,664574,651992,-16059
SOCO,"2/5/2023, Central Time",596831,586293,591234,-5597
SOCO,"2/6/2023, Central Time",607105,597366,606513,-592
SOCO,"2/7/2023, Central Time",602487,586670,611155,8668
SOCO,"2/8/2023, Central Time",559872,545068,568854,8982
SOCO,"2/9/2023, Central Time",543909,545794,557813,13904
SOCO,"2/10/2023, Central Time",552166,542728,568800,16634
SOCO,"2/11/2023, Central Time",589436,578519,594779,5343
SOCO,"2/12/2023, Central Time",621344,615672,615796,-5548
SOCO,"2/13/2023, Central Time",642546,630811,644298,1752
SOCO,"2/14/2023, Central Time",609832,595024,613414,3582
SOCO,"2/15/2023, Central Time",562720,552447,576686,13966
SOCO,"2/16/2023, Central Time",552221,541543,565669,13448
SOCO,"2/17/2023, Central Time",591972,583603,609518,17546
SOCO,"2/18/2023, Central Time",655513,643759,666359,10846
SOCO,"2/19/2023, Central Time",565672,554268,578076,12404
SOCO,"2/20/2023, Central Time",565918,553574,582129,16211
SOCO,"2/21/2023, Central Time",540374,537168,554100,13726
SOCO,"2/22/2023, Central Time",557226,560504,571324,14098
SOCO,"2/23/2023, Central Time",570449,561160,585804,15355
SOCO,"2/24/2023, Central Time",553533,544641,580986,27453
SOCO,"2/25/2023, Central Time",511820,509364,538149,26329
SOCO,"2/26/2023, Central Time",508743,489955,526871,18128
SOCO,"2/27/2023, Central Time",552774,547072,565891,13117
SOCO,"2/28/2023, Central Time",567407,557732,585634,18227
SOCO,"3/1/2023, Central Time",566263,562602,595171,28908
SOCO,"3/2/2023, Central Time",552990,551472,580638,27648
SOCO,"3/3/2023, Central Time",543903,534736,567586,23683
SOCO,"3/4/2023, Central Time",500611,493401,533484,32873
SOCO,"3/5/2023, Central Time",500515,499110,528271,27756
SOCO,"3/6/2023, Central Time",553901,549322,579876,25975
SOCO,"3/7/2023, Central Time",572761,561566,601823,29062
SOCO,"3/8/2023, Central Time",540117,534495,586944,46827
SOCO,"3/9/2023, Central Time",547105,546103,580902,33797
SOCO,"3/10/2023, Central Time",537725,531344,571765,34040
SOCO,"3/11/2023, Central Time",517638,516593,539462,21824
SOCO,"3/12/2023, Central Time",500293,493521,529832,29539
SOCO,"3/13/2023, Central Time",570249,571446,602472,32223
SOCO,"3/14/2023, Central Time",647559,623334,657389,9830
SOCO,"3/15/2023, Central Time",653244,641370,657047,3803
SOCO,"3/16/2023, Central Time",614779,604870,623174,8395
SOCO,"3/17/2023, Central Time",555065,550040,571770,16705
SOCO,"3/18/2023, Central Time",580818,578330,596655,15837
SOCO,"3/19/2023, Central Time",626976,621000,642221,15245
SOCO,"3/20/2023, Central Time",695034,693888,697437,2403
SOCO,"3/21/2023, Central Time",650993,662914,664107,13114
SOCO,"3/22/2023, Central Time",578078,571783,609260,31182
SOCO,"3/23/2023, Central Time",564095,560767,592626,28531
SOCO,"3/24/2023, Central Time",566105,578191,594785,28680
SOCO,"3/25/2023, Central Time",548533,546331,559851,11318
SOCO,"3/26/2023, Central Time",527056,525727,538505,11449
SOCO,"3/27/2023, Central Time",567833,559865,582333,14500
SOCO,"3/28/2023, Central Time",538263,531938,556733,18470
SOCO,"3/29/2023, Central Time",535050,534725,560855,25805
SOCO,"3/30/2023, Central Time",552853,556303,565479,12626
SOCO,"3/31/2023, Central Time",535918,532183,550996,15078
SOCO,"4/1/2023, Central Time",519935,516016,534868,14933
SOCO,"4/2/2023, Central Time",488128,478127,505861,17733
SOCO,"4/3/2023, Central Time",540144,533960,570624,30480
SOCO,"4/4/2023, Central Time",583051,580436,615132,32081
SOCO,"4/5/2023, Central Time",625090,618728,664283,39193
SOCO,"4/6/2023, Central Time",616174,614663,659113,42939
SOCO,"4/7/2023, Central Time",560413,550324,596218,35805
SOCO,"4/8/2023, Central Time",520409,502324,540560,20151
SOCO,"4/9/2023, Central Time",508975,511853,522658,13683
SOCO,"4/10/2023, Central Time",541422,536582,573531,32109
SOCO,"4/11/2023, Central Time",550336,548445,581984,31648
SOCO,"4/12/2023, Central Time",546683,548178,578049,31366
SOCO,"4/13/2023, Central Time",540334,536807,576262,35928
SOCO,"4/14/2023, Central Time",540702,530711,577883,37181
SOCO,"4/15/2023, Central Time",527366,550166,560315,32949
SOCO,"4/16/2023, Central Time",511422,501799,548858,37436
SOCO,"4/17/2023, Central Time",524735,519001,570551,45816
SOCO,"4/18/2023, Central Time",547718,542680,585066,37348
SOCO,"4/19/2023, Central Time",566349,557197,602462,36113
SOCO,"4/20/2023, Central Time",573510,571592,613951,40441
SOCO,"4/21/2023, Central Time",563761,555920,603884,40123
SOCO,"4/22/2023, Central Time",511042,502968,545878,34836
SOCO,"4/23/2023, Central Time",493882,486093,531016,37134
SOCO,"4/24/2023, Central Time",528446,530200,560971,32525
SOCO,"4/25/2023, Central Time",547673,539198,583381,35708
SOCO,"4/26/2023, Central Time",555102,544203,596276,41174
SOCO,"4/27/2023, Central Time",547463,536751,588820,41357
SOCO,"4/28/2023, Central Time",558348,548862,607139,48791
SOCO,"4/29/2023, Central Time",514856,515228,570953,56097
SOCO,"4/30/2023, Central Time",496183,491221,541543,45360
SOCO,"5/1/2023, Central Time",529123,538436,586944,57821
SOCO,"5/2/2023, Central Time",538209,539571,596206,57997
SOCO,"5/3/2023, Central Time",539927,532690,599958,60031
SOCO,"5/4/2023, Central Time",551087,548659,603173,52086
SOCO,"5/5/2023, Central Time",526248,528167,567144,40896
SOCO,"5/6/2023, Central Time",521109,510731,562315,41206
SOCO,"5/7/2023, Central Time",562728,545562,610409,47681
SOCO,"5/8/2023, Central Time",630361,621065,686684,56323
SOCO,"5/9/2023, Central Time",661172,650450,712138,50966
SOCO,"5/10/2023, Central Time",654564,643892,698384,43820
SOCO,"5/11/2023, Central Time",642654,653718,686196,43542
SOCO,"5/12/2023, Central Time",609921,607051,659151,49230
SOCO,"5/13/2023, Central Time",611030,598594,653081,42051
SOCO,"5/14/2023, Central Time",649221,640203,690151,40930
SOCO,"5/15/2023, Central Time",688229,683328,732358,44129
SOCO,"5/16/2023, Central Time",676389,669220,725451,49062
SOCO,"5/17/2023, Central Time",632512,639596,688287,55775
SOCO,"5/18/2023, Central Time",603289,596359,667129,63840
SOCO,"5/19/2023, Central Time",578649,575749,629196,50547
SOCO,"5/20/2023, Central Time",577585,568884,623535,45950
SOCO,"5/21/2023, Central Time",586727,578201,623685,36958
SOCO,"5/22/2023, Central Time",599646,602279,649825,50179
SOCO,"5/23/2023, Central Time",572106,561806,626444,54338
SOCO,"5/24/2023, Central Time",587805,580261,651650,63845
SOCO,"5/25/2023, Central Time",601145,593368,654280,53135
SOCO,"5/26/2023, Central Time",580990,574580,622295,41305
SOCO,"5/27/2023, Central Time",522488,531332,557827,35339
SOCO,"5/28/2023, Central Time",521608,531961,555094,33486
SOCO,"5/29/2023, Central Time",543171,539377,588069,44898
SOCO,"5/30/2023, Central Time",614509,603711,665413,50904
SOCO,"5/31/2023, Central Time",631487,628757,687454,55967
SOCO,"6/1/2023, Central Time",649588,631602,703449,53861
SOCO,"6/2/2023, Central Time",668656,658884,720538,51882
SOCO,"6/3/2023, Central Time",643462,629596,688410,44948
SOCO,"6/4/2023, Central Time",608611,594363,661598,52987
SOCO,"6/5/2023, Central Time",655118,641442,708384,53266
SOCO,"6/6/2023, Central Time",698501,694923,726957,28456
SOCO,"6/7/2023, Central Time",707062,693179,729226,22164
SOCO,"6/8/2023, Central Time",689940,679941,715872,25932
SOCO,"6/9/2023, Central Time",655233,641954,690027,34794
SOCO,"6/10/2023, Central Time",628110,614859,664228,36118
SOCO,"6/11/2023, Central Time",638944,616050,673615,34671
SOCO,"6/12/2023, Central Time",675922,674771,717181,41259
SOCO,"6/13/2023, Central Time",644155,633377,687133,42978
SOCO,"6/14/2023, Central Time",635011,631165,675298,40287
SOCO,"6/15/2023, Central Time",648359,624857,690672,42313
SOCO,"6/16/2023, Central Time",694514,687152,736736,42222
SOCO,"6/17/2023, Central Time",673878,663234,705301,31423
SOCO,"6/18/2023, Central Time",637699,655026,672971,35272
SOCO,"6/19/2023, Central Time",655896,645931,692017,36121
SOCO,"6/20/2023, Central Time",682213,669752,724046,41833
SOCO,"6/21/2023, Central Time",638212,629621,682992,44780
SOCO,"6/22/2023, Central Time",642285,627451,685712,43427
SOCO,"6/23/2023, Central Time",671814,667405,709148,37334
SOCO,"6/24/2023, Central Time",666933,655449,684302,17369
SOCO,"6/25/2023, Central Time",691959,701625,714005,22046
SOCO,"6/26/2023, Central Time",755718,736762,767070,11352
SOCO,"6/27/2023, Central Time",780477,766506,791240,10763
SOCO,"6/28/2023, Central Time",776582,771496,795469,18887
SOCO,"6/29/2023, Central Time",792994,792174,831059,38065
SOCO,"6/30/2023, Central Time",757285,764596,802435,45150
SOCO,"7/1/2023, Central Time",758647,753039,785586,26939
SOCO,"7/2/2023, Central Time",736136,726215,762187,26051
SOCO,"7/3/2023, Central Time",733576,721693,760047,26471
SOCO,"7/4/2023, Central Time",705233,693640,736691,31458
SOCO,"7/5/2023, Central Time",742753,732839,778078,35325
SOCO,"7/6/2023, Central Time",772101,760069,806189,34088
SOCO,"7/7/2023, Central Time",757329,746085,783609,26280
SOCO,"7/8/2023, Central Time",731182,720109,754643,23461
SOCO,"7/9/2023, Central Time",715992,705786,734518,18526
SOCO,"7/10/2023, Central Time",726505,718885,749971,23466
SOCO,"7/11/2023, Central Time",759215,749086,786369,27154
SOCO,"7/12/2023, Central Time",786648,775398,807181,20533
SOCO,"7/13/2023, Central Time",791219,775253,816074,24855
SOCO,"7/14/2023, Central Time",795052,782088,817808,22756
SOCO,"7/15/2023, Central Time",777292,760541,796950,19658
SOCO,"7/16/2023, Central Time",766056,756257,787707,21651
SOCO,"7/17/2023, Central Time",771683,760123,797036,25353
SOCO,"7/18/2023, Central Time",807572,796553,819669,12097
SOCO,"7/19/2023, Central Time",817529,794698,827555,10026
SOCO,"7/20/2023, Central Time",835415,838385,847579,12164
SOCO,"7/21/2023, Central Time",810101,799076,824137,14036
SOCO,"7/22/2023, Central Time",709156,697048,739534,30378
SOCO,"7/23/2023, Central Time",706091,695187,731822,25731
SOCO,"7/24/2023, Central Time",764561,754391,797184,32623
SOCO,"7/25/2023, Central Time",791230,778337,817611,26381
SOCO,"7/26/2023, Central Time",823926,810290,859327,35401
SOCO,"7/27/2023, Central Time",851766,835689,897538,45772
SOCO,"7/28/2023, Central Time",818805,803425,871582,52777
SOCO,"7/29/2023, Central Time",775465,763930,806443,30978
SOCO,"7/30/2023, Central Time",750913,737043,769181,18268
SOCO,"7/31/2023, Central Time",804406,800637,837092,32686
SOCO,"8/1/2023, Central Time",808525,800041,837620,29095
SOCO,"8/2/2023, Central Time",796764,784239,829475,32711
SOCO,"8/3/2023, Central Time",777664,763592,798216,20552
SOCO,"8/4/2023, Central Time",759980,745934,795443,35463
SOCO,"8/5/2023, Central Time",778367,756919,823152,44785
SOCO,"8/6/2023, Central Time",749898,788738,798943,49045
SOCO,"8/7/2023, Central Time",786129,801553,824906,38777
SOCO,"8/8/2023, Central Time",753963,741291,791224,37261
SOCO,"8/9/2023, Central Time",775670,762703,817375,41705
SOCO,"8/10/2023, Central Time",784903,767165,828983,44080
SOCO,"8/11/2023, Central Time",783128,769517,832510,49382
SOCO,"8/12/2023, Central Time",772476,765389,820763,48287
SOCO,"8/13/2023, Central Time",788279,772779,838714,50435
SOCO,"8/14/2023, Central Time",867587,851344,905406,37819
SOCO,"8/15/2023, Central Time",813402,798309,851724,38322
SOCO,"8/16/2023, Central Time",737022,731465,776833,39811
SOCO,"8/17/2023, Central Time",740788,728555,776469,35681
SOCO,"8/18/2023, Central Time",762599,747904,800430,37831
SOCO,"8/19/2023, Central Time",743692,730259,770987,27295
SOCO,"8/20/2023, Central Time",762913,747298,786631,23718
SOCO,"8/21/2023, Central Time",841459,827331,885165,43706
SOCO,"8/22/2023, Central Time",870637,855607,895246,24609
SOCO,"8/23/2023, Central Time",876753,860667,877979,1226
SOCO,"8/24/2023, Central Time",859832,842478,869812,9980
SOCO,"8/25/2023, Central Time",871888,856666,884901,13013
SOCO,"8/26/2023, Central Time",846227,832946,860509,14282
SOCO,"8/27/2023, Central Time",809071,798324,814430,5359
SOCO,"8/28/2023, Central Time",787257,792440,808686,21429
SOCO,"8/29/2023, Central Time",764727,751152,784483,19756
SOCO,"8/30/2023, Central Time",703110,693738,729055,25945
SOCO,"8/31/2023, Central Time",724013,712904,748152,24139
SOCO,"9/1/2023, Central Time",691593,679781,706867,15274
SOCO,"9/2/2023, Central Time",630086,622350,653841,23755
SOCO,"9/3/2023, Central Time",652653,641483,682270,29617
SOCO,"9/4/2023, Central Time",694967,682905,731726,36759
SOCO,"9/5/2023, Central Time",736461,723995,783423,46962
SOCO,"9/6/2023, Central Time",768241,748543,801864,33623
SOCO,"9/7/2023, Central Time",773747,759831,806823,33076
SOCO,"9/8/2023, Central Time",706975,693395,735443,28468
SOCO,"9/9/2023, Central Time",673663,660127,702844,29181
SOCO,"9/10/2023, Central Time",682115,667645,701782,19667
SOCO,"9/11/2023, Central Time",749330,736051,768766,19436
SOCO,"9/12/2023, Central Time",743509,730967,761567,18058
SOCO,"9/13/2023, Central Time",722129,709948,737386,15257
SOCO,"9/14/2023, Central Time",679904,665864,704966,25062
SOCO,"9/15/2023, Central Time",649572,634076,670658,21086
SOCO,"9/16/2023, Central Time",596378,581398,627803,31425
SOCO,"9/17/2023, Central Time",609303,602485,635976,26673
SOCO,"9/18/2023, Central Time",618143,606221,648668,30525
SOCO,"9/19/2023, Central Time",625428,613698,647914,22486
SOCO,"9/20/2023, Central Time",629021,616907,647984,18963
SOCO,"9/21/2023, Central Time",647088,633290,669552,22464
SOCO,"9/22/2023, Central Time",632573,616525,657761,25188
SOCO,"9/23/2023, Central Time",594984,591661,626416,31432
SOCO,"9/24/2023, Central Time",601251,590203,625232,23981
SOCO,"9/25/2023, Central Time",653943,644931,688077,34134
SOCO,"9/26/2023, Central Time",670719,660136,696519,25800
SOCO,"9/27/2023, Central Time",625994,619843,657422,31428
SOCO,"9/28/2023, Central Time",598177,594322,628891,30714
SOCO,"9/29/2023, Central Time",619573,610662,647979,28406
SOCO,"9/30/2023, Central Time",611095,600763,628929,17834
SOCO,"10/1/2023, Central Time",594309,581780,625807,31498
SOCO,"10/2/2023, Central Time",617242,614198,661060,43818
SOCO,"10/3/2023, Central Time",611883,611347,657685,45802
SOCO,"10/4/2023, Central Time",617981,616865,661226,43245
SOCO,"10/5/2023, Central Time",617066,610048,648377,31311
SOCO,"10/6/2023, Central Time",610364,596919,623993,13629
SOCO,"10/7/2023, Central Time",516829,508384,531005,14176
SOCO,"10/8/2023, Central Time",486528,473292,501722,15194
SOCO,"10/9/2023, Central Time",537494,527089,552649,15155
SOCO,"10/10/2023, Central Time",558260,548265,578594,20334
SOCO,"10/11/2023, Central Time",542748,536407,567096,24348
SOCO,"10/12/2023, Central Time",535347,527056,561414,26067
SOCO,"10/13/2023, Central Time",532172,522299,550880,18708
SOCO,"10/14/2023, Central Time",511708,500396,526684,14976
SOCO,"10/15/2023, Central Time",480415,470481,500790,20375
SOCO,"10/16/2023, Central Time",536232,528345,571477,35245
SOCO,"10/17/2023, Central Time",546662,536733,583910,37248
SOCO,"10/18/2023, Central Time",548777,540446,570898,22121
SOCO,"10/19/2023, Central Time",542553,534584,568694,26141
SOCO,"10/20/2023, Central Time",536035,530778,563458,27423
SOCO,"10/21/2023, Central Time",501695,491589,513226,11531
SOCO,"10/22/2023, Central Time",501057,492571,514232,13175
SOCO,"10/23/2023, Central Time",544015,533633,569593,25578
SOCO,"10/24/2023, Central Time",551884,544038,578016,26132
SOCO,"10/25/2023, Central Time",559554,551501,584669,25115
SOCO,"10/26/2023, Central Time",571088,561676,595394,24306
SOCO,"10/27/2023, Central Time",560810,551743,587090,26280
SOCO,"10/28/2023, Central Time",515797,524010,545299,29502
SOCO,"10/29/2023, Central Time",518578,522356,550509,31931
SOCO,"10/30/2023, Central Time",524736,554736,563300,38564
SOCO,"10/31/2023, Central Time",531578,550922,588329,56751